	Fu8	Q
	FuH	m
	Fut	P
00databasealphabet	1Wu	q
00databasedictfmt1121	B	b
00databaseinfo	c	XG
00databaseshort	Xi	x
00databaseurl	YT	V
00databaseutf8	A	B
a	FvM	W
a	TG8	s
a	TH9	W
a	THo	V
a	TIT	S
aag	Fvi	j
aai	FwF	m
aak	Fwr	m
aaklig	FxR	BN
aakligheid	Fye	BQ
aal	Fzu	S
aalagtig	F0A	l
aalbessie	F0l	1
aalbessiebos	F1a	4
aalbessiesap	F2S	w
aalbessievla	F3C	0
aalfuik	F32	t
aalmoes	F4j	j
aalmoesenier	F5G	BC
aalmoeseniershuis	F6I	BR
aalmoesenierskap	F7Z	4
aalmoeskassie	F8R	t
aalpastei	F8+	p
aalsvel	F9n	f
aaltjie	F+G	d
aalverkoper	F+j	v
aalvissery	F/S	w
aalvormig	GAC	5
aalwee	GA7	a
aalweeagtig	GBV	r
aalwurm	GCA	i
aalwyn	GCi	c
aalwynagtig	GC+	t
aalwynbitter	GDr	s
aalwynhout	GEX	t
aalwynsap	GFE	r
aalwyntapper	GFv	Bg
aam	GHP	S
aambeeld	GHh	m
aambeeldbeentjie	GIH	+
aambeeldbeitel	GJF	w
aambeeldvoël	GJ1	4
aambei	GKt	0
aambeie	GLh	l
aambeipoeier	GMG	x
aamborstig	GM3	w
aamborstigheid	GNn	Bp
aan	GPQ	Br
aan	I0N	g
aan	I0t	c
aan	I1J	Y
aan	I1h	T
aanbehoort	GQ7	r
aanbel	GRm	2
aanbesteding	GSc	t
aanbestee	GTJ	BE
aanbetref	GUN	z
aanbetrou	GVA	BL
aanbeveel	GWL	x
aanbeveelbaar	GW8	2
aanbevelenswaardig	GXy	BF
aanbeveling	GY3	z
aanbid	GZq	k
aanbidbaar	GaO	o
aanbiddelik	Ga2	p
aanbidding	Gbf	w
aanbied	GcP	y
aanbieding	GdB	/
aanblaas	GeA	k
aanblik	Gek	9
aanbly	Gfh	v
aanbod	GgQ	b
aanboor	Ggr	4
aanbou	Ghj	p
aanbrand	GiM	q
aanbrandsteker	Gi2	y
aanbreek	Gjo	BT
aanbring	Gk7	9
aand	Gl4	Y
aandag	GmQ	/
aandag	Go2	BK
aandag	GqA	k
aandag	Gqk	q
aandagtig	GnP	4
aandagtiglik	GoH	v
aandblad	GrO	n
aandeel	Gr1	y
aandeel	GuL	o
aandeelhebber	Gsn	y
aandeelhouer	GtZ	y
aandelekapitaal	Guz	+
aandenking	Gvx	7
aandete	Gws	u
aandgebed	Gxa	s
aandgrou	GyG	f
aandien	Gyl	2
aandiening	Gzb	u
aandjapon	G0J	6
aandklok	G1D	g
aandkoerant	G1j	u
aandkostuum	G2R	u
aandland	ZK	i
aandoen	G2/	BL
aandoening	G4K	0
aandoenlik	G4+	4
aandra	G52	k
aandraag	G6a	n
aandraai	G7B	4
aandrang	G75	BQ
aandrif	G9J	w
aandring	G95	g
aandruk	G+Z	r
aandryf	G/E	Bf
aandryfas	HAj	6
aandrywe	HBd	Bi
aandrywing	HC/	m
aandskemering	HDl	r
aandskool	HEQ	BO
aandster	Zs	t
aandui	HFe	9
aanduiding	HGb	p
aandurf	HHE	BG
aaneen	HIK	o
aaneen	HIy	Bd
aaneenbind	HKP	u
aaneenskakeling	HK9	0
aaneenvoeg	HLx	q
aanerd	HMb	0
aanfluiting	HNP	o
aangee	HN3	BA
aangenaam	HO3	BM
aangenome	HQD	4
aangesien	HQ7	BO
aangeskote	HSJ	/
aangetroud	HTI	BU
aangetroude	HUc	3
aangewing	HVT	p
aangifte	HV8	/
aangrensend	HW7	1
aangry	HXw	4
aanhaal	HYo	k
aanhaling	HZM	y
aanhalingstekens	HZ+	BJ
aanhang	HbH	BK
aanhanklik	HcR	/
aanhanklikheid	HdQ	BM
aanhef	Hec	j
aanhou	He/	v
aanhoudelik	Hfu	z
aanhoudend	Hgh	Bg
aanhouding	HiB	/
aanhê	HjA	a
aankla	Hja	f
aanklaag	Hj5	i
aanklae	Hkb	g
aanklaer	Hk7	j
aanklag	Hle	s
aankoms	HmK	g
aankondig	Hmq	BA
aankondiger	Hnq	v
aankondiging	HoZ	2
aankoop	HpP	v
aankweek	Hp+	q
aankyker	Hqo	n
aanland	HrP	e
aanleghawe	Hrt	w
aanlegplek	Hsd	2
aanleiding	HtT	8
aanlok	HuP	j
aanloklik	Huy	n
aanloklikheid	HvZ	BK
aanloksel	Hwj	n
aanlonk	HxK	1
aanloop	Hx/	c
aanloophawe	Hyb	z
aanlê	HzO	a
aanlêhawe	Hzo	w
aanlêplaas	H0Y	5
aanlêplek	H1R	2
aanmaak	H2H	BJ
aanmaan	H3Q	o
aanmaning	H34	2
aanmaningsbrief	H4u	8
aanmerklik	H5q	0
aanminlik	H6e	t
aanmoedig	H7L	m
aanmoediging	H7x	v
aanneem	H8g	1
aanneembaar	H9V	t
aanneemlik	H+C	4
aannemer	H+6	BT
aanpak	IAN	o
aanpas	IA1	c
aanpasbaar	IBR	p
aanplak	IB6	u
aanplakbiljet	ICo	/
aanplakbord	IDn	/
aanprys	IEm	s
aanprysing	IFS	v
aanraai	IGB	n
aanraak	IGo	e
aanrading	IHG	u
aanraking	IH0	k
aanrand	IIY	o
aanrander	IJA	x
aanranding	IJx	m
aanreg	IKX	d
aanroep	IK0	n
aans	ILb	8
aansien	IMX	BZ
aansienlik	INw	p
aansies	IOZ	BB
aansig	IPa	7
aansit	IQV	BK
aanskakel	IRf	BN
aanskerp	ISs	h
aanslag	ITN	w
aansluit	IT9	BD
aansluiting	IVA	BD
aansoek	IWD	q
aansoek	IWt	BI
aanspreeklik	IX1	7
aanstaande	IYw	5
aansteker	IZp	l
aanstel	IaO	f
aanstelling	Iat	BC
aansterf	Ibv	h
aanstoot	IcQ	BJ
aansyn	IdZ	w
aansê	IeJ	2
aantal	Ie/	k
aantas	Ifj	d
aanteken	IgA	s
aantekening	Igs	z
aantonende	Ihf	9
aantoon	Iic	BD
aantrek	Ijf	e
aantrekkingskrag	Ij9	3
aantreklik	Ik0	p
aantreklikheid	Ild	BM
aanvaar	Imp	3
aanvaarbaar	Ing	t
aanvaarder	IoN	o
aanvaarding	Io1	3
aanval	Ips	+
aanvaller	Iqq	6
aanvallig	Irk	s
aanvalligheid	IsQ	t
aanvang	Is9	BM
aanvanger	IuJ	l
aanvangsalaris	Iuu	+
aanvangsletter	Ivs	w
aanvangsnelheid	Iwc	9
aanvanklik	IxZ	BJ
aanvanklike	Iyi	q
aanvul	IzM	e
aanwesig	Izq	j
aap	I10	a
aapagtig	I2O	7
aar	I3J	d
aarbei	I3m	h
aarbeiboom	I4H	7
aarbeiboomvrug	I5C	5
aard	I57	v
aardbewing	I6q	q
aardbol	I7U	p
aarde	I79	y
aardgas	I8v	j
aardgees	I9S	w
aardgordel	I+C	j
aardhommel	I+l	n
aardig	I/M	c
aardkloot	I/o	u
aardkunde	JAW	k
aardkundig	JA6	p
aardkundige	JBj	r
aardmannetjie	JCO	5
aardrykskunde	JDH	z
aardrykskundig	JD6	BE
aardrykskundige	JE+	5
aards	JF3	w
aardskok	JGn	q
aardskudding	JHR	s
aardtrilling	JH9	r
aardverskuiwing	JIo	1
aardwolf	JJd	i
aars	JJ/	b
aartappel	JKa	i
aartappelmeel	JK8	z
aartsbisdom	JLv	w
aartsbiskop	JMf	t
aartsdom	JNM	t
aartsengel	JN5	o
aartsherog	JOh	q
aartshertogdom	JPL	z
aartsvader	JP+	q
aartsvyand	JQo	v
aarverkalking	JRX	4
aas	JSP	u
aasvoël	JS9	i
ab	JTf	Y
abakus	JT3	BH
abattoir	JU+	BM
abc	JWK	W
abdikasie	JWg	m
abdis	JXG	Z
abdominaal	JXf	o
abdy	JYH	Y
abeel	JYf	Y
abessinies	aZ	p
abessinië	bC	u
abessiniër	bw	v
ablatief	JY3	g
abnormaal	JZX	l
abom	Yo	i
abonnee	JZ8	h
abonnement	Jad	s
abonnent	JbJ	j
aborteur	Jbs	m
absensie	JcS	x
absent	JdD	b
abses	Jde	a
absint	Jd4	c
absolutisme	JeU	q
absorpsie	Je+	k
abstraheer	Jfi	m
abstrak	JgI	f
absurd	Jgn	b
absurditeit	JhC	/
abuis	JiB	t
abusieflik	Jiu	q
achilles	cf	f
achilleshiel	c+	v
achillespees	dt	z
achternadraai	JjY	s
acre	JkE	V
adagio	JkZ	i
adam	eg	V
adamsappel	Jk7	u
adder	Jlp	e
adekwaat	JmH	n
adel	Jmu	b
adelaar	JnJ	i
adelik	Jnr	m
adem	JoR	Z
ademhaling	Joq	w
ademloos	Jpa	p
aden	e1	X
adieu	JqD	w
adjektief	Jqz	l
adjektiwies	JrY	q
administrasie	JsC	BA
administrateur	JtC	BE
administratief	JuG	0
administreer	Ju6	1
admiraal	Jvv	h
adonis	fM	e
adopsie	JwQ	i
adoptief	Jwy	k
adoreer	JxW	p
adrenalien	Jx/	n
adrenaline	Jym	p
adres	JzP	a
adresboek	Jzp	m
adresseer	J0P	i
adresseermasjien	J0x	9
adresverandering	J1u	BA
adriatiese	fq	3
adverbiaal	J2u	q
adverbium	J3Y	k
adverteer	J38	+
advertensie	J46	y
advies	J5s	9
adviseer	J6p	q
afasie	J7T	f
afbreek	J7y	p
afdeling	J8b	Bu
afdelingswinkel	J+J	BG
afding	J/P	m
afdwaal	J/1	u
affiks	KAj	Z
affiniteit	KA8	n
affêre	KBj	BF
affêring	KCo	BJ
afgaan	KDx	x
afgaan	gh	e
afgaans	g/	g
afganistan	hf	s
afgee	KEi	Z
afgelope	KE7	j
afgod	KFe	Z
afgrond	KF3	4
afgryse	KGv	7
afgryslik	KHq	BD
afguns	KIt	b
afgunstig	KJI	j
afhaal	KJr	p
afhanklik	KKU	m
afhanklikheid	KK6	z
afkappingsteken	KLt	4
afklim	KMl	w
afkomstig	KNV	i
afkondig	KN3	BP
aflewer	KPG	z
aflewering	KP5	q
afmeting	KQj	z
afneem	KRW	u
afoes	KSE	a
aforisme	KSe	n
afraai	KTF	0
afrika	iL	f
afrikaan	iq	h
afrikaans	jL	z
afrikaner	j+	9
afrikanertjie	KT5	2
afrikanertroos	k7	y
afroasiaties	lt	8
afroep	KUv	e
afrond	KVN	n
afroom	KV0	j
afros	KWX	n
afruim	KW+	3
afruk	KX1	q
afry	KYf	q
afsegging	KZJ	y
afsend	KZ7	BI
afsender	KbD	i
afset	Kbl	u
afsetgebied	KcT	5
afsetter	KdM	w
afsettery	Kd8	0
afsien	Kew	3
afsien	Kfn	w
afsigtelik	KgX	+
afsit	KhV	CO
afsitting	Kjj	n
afskaduwing	KkK	3
afskaf	KlB	BP
afskaffer	KmQ	5
afskaffing	KnJ	0
afskakel	Kn9	Be
afskeep	Kpb	5
afskeer	KqU	p
afskei	Kq9	2
afskeid	Krz	3
afskeid	KuZ	BS
afskeiding	Ksq	BG
afskeids	Ktw	p
afskerm	Kvr	h
afskeur	KwM	v
afskeuring	Kw7	n
afskiet	Kxi	BJ
afskil	Kyr	i
afskilder	KzN	j
afskilfer	Kzw	8
afskrif	K0s	d
afskrik	K1J	BX
afskrikwekkend	K2g	9
afskryf	K3d	7
afskud	K4Y	g
afskuim	K44	d
afskuiwe	K5V	k
afskuwelik	K55	CA
afslaan	K75	BT
afslaer	K9M	k
afslag	K9w	y
afsluit	K+i	B4
afsluiting	LAa	4
afslyt	LBS	2
afsnou	LCI	v
afsny	LC3	e
afsoek	LDV	b
afsoen	LDw	u
afsonder	LEe	BM
afsondering	LFq	3
afsonderlik	LGh	Bf
afsper	LIA	k
afsplits	LIk	z
afspoel	LJX	k
afspraak	LJ7	Bg
afspreek	LLb	g
afspring	LL7	BQ
afstaan	LNL	BN
afstam	LOY	+
afstammeling	LPW	4
afstand	LQO	BJ
afstand	LTO	BM
afstandsbediening	LRX	+
afstandsbeheer	LSV	5
afstap	LUa	w
afsteek	LVK	v
afstel	LV5	q
afstem	LWj	o
afstempel	LXL	p
afsterf	LX0	n
afsterwe	LYb	q
afstewen	LZF	s
afstof	LZx	b
afstomp	LaM	4
afstootlik	LbE	+
afstroop	LcC	BB
afstudeer	LdD	x
afstuit	Ld0	g
afstyg	LeU	h
afsweer	Le1	BN
afswering	LgC	8
afsydig	Lg+	+
afsê	Lh8	BW
aftak	LjS	b
aftakking	Ljt	m
aftandig	LkT	BL
aftands	Lle	BI
aftap	Lmm	x
aftapkraan	LnX	t
afteken	LoE	n
aftel	Lor	f
aftelefoneer	LpK	BS
aftog	Lqc	c
aftreding	Lq4	q
aftree	Lri	y
aftrek	LsU	CT
aftrekbaar	Lun	r
aftrekgetal	LvS	v
aftrekker	LwB	n
aftrekking	Lwo	q
aftreksel	LxS	v
aftreksom	LyB	t
aftroef	Lyu	c
afvaardig	LzK	l
afvaart	Lzv	j
afval	L0S	D7
afvallig	L4N	x
afvallige	L4+	BI
afvalproduk	L6G	x
afvalwater	L63	r
afvee	L7i	r
afveeg	L8N	t
afvloei	L86	r
afvoer	L9l	7
afvoerbuis	L+g	BJ
afvoerder	L/p	m
afvuur	MAP	u
afwaarts	MA9	x
afwag	MBu	BB
afwagting	MCv	p
afwater	MDY	h
afwatering	MD5	r
afweer	MEk	0
afwen	MFY	Bo
afwend	MHA	g
afwentel	MHg	k
afwerk	MIE	n
afwerking	MIr	r
afwerp	MJW	Bt
afwesig	MLD	f
afwesig	MNE	/
afwesige	MLi	k
afwesigheid	MMG	+
afwikkel	MOD	B0
afwikkeling	MP3	2
afwimpel	MQt	i
afwis	MRP	r
afwyk	MR6	BF
afwyking	MS/	B0
afwys	MUz	BB
afwysing	MV0	1
ag	MWp	Cj
ag	NvE	BC
agaat	MZM	Z
agarm	MZl	e
agbaar	MaD	h
ageer	Mak	j
agenda	MbH	u
agent	Mb1	o
agentskap	Mcd	i
agentuur	Mc/	e
agglomeraat	Mdd	x
aggregaat	MeO	n
aggressie	Me1	p
aggressief	Mfe	m
aghoek	MgE	a
agio	Mge	a
agitasie	Mg4	u
agitator	Mhm	k
agiteer	MiK	1
agiteerder	Mi/	m
agnosties	Mjl	i
agnostikus	MkH	o
agorafobie	Mkv	1
agrariër	Mlk	w
agronomie	MmU	y
agronomies	MnG	s
agronoom	Mny	p
agste	Mob	r
agtal	MpG	i
agtallig	Mpo	e
agtarm	MqG	e
agteloos	Mqk	w
agteloosheid	MrU	/
agtelosig	MsT	y
agtelosigheid	MtF	BC
agtenswaard	MuH	u
agtenswaardig	Mu1	z
agter	Mvo	g
agter	Nod	a
agteraan	MwI	9
agteras	MxF	5
agterbalkon	Mx+	w
agterbank	Myu	z
agterbly	Mzh	BG
agterblyer	M0n	1
agterboeg	M1c	x
agterbuurt	M2N	v
agterdeel	M28	o
agterdeur	M3k	q
agterdog	M4O	l
agterdogtig	M4z	r
agtereen	M5e	BV
agtereenvolgens	M6z	3
agterent	M7q	Bv
agtergedeelte	M9Z	y
agtergrond	M+L	BN
agterhoede	M/Y	8
agterhoof	NAU	4
agterhou	NBM	7
agterin	NCH	g
agterindië	mp	3
agterkant	NCn	o
agterklap	NDP	6
agterkleindogter	NEJ	BB
agterkleinkind	NFK	6
agterkleinseun	NGE	4
agterlaag	NG8	l
agterlaat	NHh	r
agterlamp	NIM	BF
agterland	NJR	o
agterlig	NJ5	BB
agterlik	NK6	BA
agterlikheid	NL6	y
agterloop	NMs	m
agterlosig	NNS	0
agtermiddag	NOG	p
agternaam	NOv	o
agternadoen	NPX	q
agternadraai	NQB	/
agternagaan	NRA	v
agterneef	NRv	BA
agternig	NSv	7
agterniggie	NTq	BB
agteroor	NUr	BC
agteroorval	NVt	w
agterraam	NWd	p
agterskip	NXG	z
agterstallig	NX5	8
agterstand	NY1	n
agterste	NZc	BF
agtersten	Nah	x
agterstevoor	NbS	BG
agterstewe	NcY	3
agteruit	NdP	v
agteruitboer	Nd+	0
agteruitgaan	Ney	BR
agteruitgang	NgD	BX
agteruitkykspieël	Nha	BE
agtervoegsel	Nie	o
agtervolg	NjG	/
agterwaarts	NkF	2
agterweë	Nk7	r
agterweë	Nlm	BK
agterwiel	Nmw	+
agterwyk	Nnu	v
agthoek	No3	c
agtien	NpT	b
agtiende	Npu	i
agting	NqQ	x
agtste	NrB	o
agttal	Nrp	j
agttallig	NsM	f
agtvoudig	Nsr	x
agurk	Ntc	c
agurkie	Nt4	d
agvoudig	NuV	v
ahorn	NwG	m
ai	Nws	6
aikôna	Nxm	l
air	NyL	z
akademie	Ny+	h
akademielid	Nzf	u
akant	N0N	d
akasia	N0q	e
akelei	N1I	l
aken	ng	m
akka	N1t	f
akkedis	N2M	d
akkeldis	N2p	h
akker	N3K	q
akkerboom	N30	h
akkerbou	N4V	5
akkerdis	N5O	h
akkermonie	N5v	o
akkerwinde	N6X	+
akklamasie	N7V	BA
akklimatisasie	N8V	3
akklimatiseer	N9M	BA
akklimatisering	N+M	6
akkommodasie	N/G	v
akkomodasie	N/1	BN
akkompanjeer	OBC	t
akkompanjement	OBv	BG
akkompanjis	OC1	4
akkoord	ODt	B3
akkordeon	OFk	o
akkrediteer	OGM	p
akkumulasie	OG1	t
akkumulator	OHi	BI
akkumuleer	OIq	+
akkuraat	OJo	BT
akkuraatheid	OK7	BC
akkusatief	OL9	n
akne	OMk	V
akoestiek	OM5	h
akoesties	ONa	g
akoliet	ON6	c
akoniet	OOW	n
akrobaat	OO9	h
akrobaties	OPe	n
akroniem	OQF	j
akselerasie	OQo	x
akselerator	ORZ	BF
aksent	OSe	BA
aksenteken	OTe	4
aksentueer	OUW	6
akseptabel	OVQ	r
akseptant	OV7	m
aksepteer	OWh	8
aksidenteel	OXd	t
aksie	OYK	4
aksioma	OZC	i
aksionaris	OZk	x
aksioom	OaV	g
aksyns	Oa1	s
akteur	Obh	b
aktief	Ob8	k
aktinie	Ocg	k
aktinium	OdE	j
aktiveer	Odn	BG
aktivis	Oet	r
aktiwiteit	OfY	w
aktrise	OgI	e
aktualiteit	Ogm	t
aktuaris	OhT	l
aktueel	Oh4	BR
akwadukt	OjJ	m
akwamaryn	Ojv	p
akwarel	OkY	m
akwarium	Ok+	m
al	Olk	g
al	P62	P
alarm	OmE	a
alarmeer	Ome	BB
albaans	oG	g
albanees	om	k
albanies	pK	8
albaniese	qG	6
albanië	rA	n
albas	Onf	c
albatros	On7	l
albe	Oog	U
albei	Oo0	Y
albino	OpM	a
albion	rn	d
album	Opm	Y
alchemie	Op+	f
alchemis	Oqd	j
aldaar	OrA	q
aldehide	Orq	k
aldehied	OsO	i
aldeur	Osw	Bb
aleenverteenwoordiger	OuL	BF
alexandrië	sE	w
alfa	OvQ	Y
alfabet	Ovo	i
alfabeties	OwK	q
alg	Ow0	b
alge	OxP	e
algebra	Oxt	f
algebraïes	OyM	r
algemeen	Oy3	q
algemeenheid	Ozh	+
algerië	s0	m
algeryn	ta	i
algeryns	t8	k
algiers	ug	e
alhaas	O0f	v
alhoewel	O1O	q
alibi	O14	X
alimentasie	O2P	q
alinea	O25	k
aljare	O3d	e
alkohol	O37	d
alkoholgehalte	O4Y	6
alkoholies	O5S	n
alkoholis	O55	m
alkoholisme	O6f	s
alkoholvry	O7L	w
allah	u+	Y
alle	O77	T
alledaags	O8O	BE
allee	O9S	Y
alleen	O9q	BH
alleenhandel	O+x	q
alleenheerser	O/b	8
alleenheerskapy	PAX	BV
alleenspraak	PBs	2
alleenverkoop	PCi	v
allegaartjie	PDR	BM
allegorie	PEd	m
allegories	PFD	p
allengs	PFs	x
allengskens	PGd	6
allenig	PHX	z
aller	PIK	c
alleraardigst	PIm	0
allerbekoorliks	PJa	5
allergie	PKT	e
allergies	PKx	h
allerhande	PLS	Bt
allerheilige	vW	BC
allerlei	PM/	Bp
allersiele	wY	s
allerweë	POo	x
alles	PPZ	9
allesbehalwe	PQW	v
allesbeheersend	PRF	BR
allesins	PSW	BP
alliansie	PTl	j
alliasie	PUI	g
allig	PUo	9
alligator	PVl	p
alliterasie	PWO	v
allo	PW9	U
allooi	PXR	Z
allure	PXq	Y
alluviaal	PYC	l
alluvie	PYn	m
alluvio	PZN	s
alluvium	PZ5	s
almag	Pal	e
almal	PbD	d
almanak	Pbg	f
almeteens	Pb/	BP
alom	PdO	m
alomteenwoordig	Pd0	BG
alomvattend	Pe6	BB
alpakka	Pf7	f
alpbok	Pga	Z
alpe	xE	V
alperoos	Pgz	1
alpeviooltjie	Pho	t
alpien	xZ	Z
alpinies	xy	f
alpinis	PiV	BJ
alpyns	yR	d
alras	Pje	X
alreeds	Pj1	r
als	P58	6
alsem	Pkg	a
also	Pk6	h
alt	Plb	z
altaar	PmO	b
altaardienaar	Pmp	u
altaarstuk	PnX	r
altans	PoC	d
alteenwoordig	Pof	/
altemit	Ppe	BF
altemits	Pqj	BH
altemitters	Prq	BN
alternatief	Ps3	0
altoos	Ptr	i
altruïs	PuN	i
altruïsme	Puv	n
altruïsties	PvW	r
altsanger	PwB	r
altstem	Pws	8
altviool	Pxo	v
altwee	PyX	Z
altyd	Pyw	h
altyddurend	PzR	u
aluin	Pz/	X
aluminium	P0W	w
alvermoë	P1G	q
alvleesklier	P1w	s
alvorens	P2c	v
alwaar	P3L	b
alwas	P3m	a
alweer	P4A	BI
alwetend	P5I	0
amandel	P7F	e
amanuensis	P7j	1
amarant	P8Y	k
amasone	P88	h
amasone	yu	h
amateur	P9d	p
amateuragtig	P+G	/
ambag	P/F	w
ambagsman	P/1	l
ambassade	QAa	l
ambassadeur	QA/	r
ambassadrise	QBq	BB
amber	QCr	Y
ambieer	QDD	0
ambigeer	QD3	h
ambisie	QEY	d
ambisieus	QE1	n
ambroos	QFc	g
ambrosyn	QF8	l
amebe	QGh	b
amen	QG8	X
amendeer	QHT	f
amendement	QHy	q
amendering	QIc	o
amerika	zP	BE
amerikaans	0T	q
amerikaner	09	9
amerikaniseer	QJE	z
ametis	QJ3	f
ameublement	QKW	u
amfibie	QLE	g
amfiteater	QLk	u
amfora	QMS	f
amikaal	QMx	g
ammeter	QNR	e
ammoniak	QNv	k
ammonium	QOT	k
ammunisie	QO3	u
amnestie	QPl	t
amok	QQS	W
amor	16	W
amorf	QQo	c
amortisasie	QRE	t
amortiseer	QRx	w
amp	QSh	p
amper	QTK	BL
ampertjies	QUV	BA
ampgenoot	QVV	2
amplitude	QWL	m
ampsbroer	QWx	k
ampseed	QXV	l
ampsgeheim	QX6	w
ampsgewaad	QYq	w
ampsmisdryf	QZa	/
ampswoning	QaZ	y
amptelik	QbL	i
ampteloos	Qbt	m
amptenaredom	QcT	BC
amptenary	QdV	5
ampul	QeO	X
amputasie	Qel	o
amputeer	QfN	j
ampère	Qfw	e
ampèremeter	QgO	u
amulet	Qg8	s
amusant	Qho	z
amuseer	Qib	c
amusement	Qi3	/
anaal	Qj2	Y
anachronisme	QkO	y
anagram	QlA	h
anakonda	Qlh	l
analfabeet	QmG	r
analis	Qmx	z
analise	Qnk	i
analiseer	QoG	l
analogie	Qor	k
analogies	QpP	o
analoog	Qp3	k
ananas	Qqb	h
anapes	Qq8	e
anargie	Qra	f
anargies	Qr5	5
anargis	Qsy	j
anargisme	QtV	o
anatolië	2Q	2
anatomie	Qt9	f
anatomies	Quc	n
anatoom	QvD	k
andalusië	3G	v
ander	Qvn	n
anderland	QwO	t
anderlander	Qw7	s
anders	Qxn	m
andyvie	QyN	g
anekdote	Qyt	l
anekdoties	QzS	o
anemie	Qz6	c
anemies	Q0W	e
anemoon	Q00	g
angel	Q1U	j
angelier	Q13	p
angelsakser	31	0
angelsaksies	4p	0
angina	Q2g	k
anglikaan	5d	n
anglikaans	6E	p
angola	6t	h
angskreet	Q3E	q
angst	Q3u	z
angstig	Q4h	1
angsvallig	Q5W	x
angswekkend	Q6H	n
aniline	Q6u	e
animo	Q7M	BA
anker	Q8M	a
ankerplek	Q8m	6
anna	Q9g	Z
anneksasie	Q95	q
annekseer	Q+j	i
annonseer	Q/F	9
annoteer	RAC	w
annulleer	RAy	BL
annullering	RB9	3
annunsiasie	7O	6
annuïteit	RC0	z
anode	RDn	b
anomalie	REC	q
anoniem	REs	9
anonimiteit	RFp	r
anonymus	RGU	s
anorganies	RHA	q
ansjovis	RHq	j
antarktika	8I	2
antenne	RIN	m
antichris	RIz	k
antidoot	RJX	i
antiek	RJ5	j
antille	8+	e
antiloop	RKc	i
antimonium	RK+	l
antimoon	RLj	i
antipatie	RMF	r
antipatiek	RMw	h
antipode	RNR	k
antisemiet	RN1	q
antisemities	ROf	w
antisemitisme	RPP	2
antisepties	RQF	o
antisipasie	RQt	s
antisipeer	RRZ	0
antisosiaal	RSN	1
antonius	9c	l
antrasiet	RTC	k
antropologie	RTm	y
antropoloog	RUY	z
antwoord	RVL	w
anus	RV7	b
anys	RWW	Y
aorta	RWu	b
apache	RXJ	s
apart	RX1	3
apartheid	RYs	m
apatie	RZS	e
apaties	RZw	j
apebroodboom	RaT	v
apekool	RbC	m
apogeum	Rbo	c
apokalips	+B	n
apokalips	RcE	n
apokalipties	Rcr	t
apokrief	RdY	h
apopleksie	Rd5	BX
apostaat	RfQ	j
apostel	Rfz	f
apostelskap	RgS	6
apostolaat	RhM	4
apostolies	RiE	o
apostroof	Ris	n
apoteose	RjT	p
apparaat	Rj8	w
appartement	Rks	x
appel	Rld	X
appelboom	Rl0	q
appeldrank	Rme	l
appelkoos	RnD	j
appelkoosboom	Rnm	0
appelleer	Roa	g
appelmoes	Ro6	o
appeltert	Rpi	p
appelwyn	RqL	i
appendisitis	Rqt	v
applikant	Rrc	j
apploudiseer	Rr/	6
applous	Rs5	1
appèl	Rtu	z
april	+o	Y
apropos	Ruh	h
apteek	RvC	u
apteker	Rvw	g
aptyt	RwQ	d
arabesk	Rwt	h
arabier	/A	c
arabies	/c	n
arabië	BAD	k
arak	RxO	f
arapapegaai	Rxt	t
araroet	Rya	j
arbei	Ry9	Y
arbeid	RzV	f
arbeider	Rz0	Bb
arbeidsaam	R1P	1
arbeidsaamheid	R2E	0
arbeidsloos	R24	u
arbeidsloosheid	R3m	6
arbeidsmark	R4g	+
arbeidster	R5e	BL
ardenne	BAn	f
are	R6p	m
area	R7P	Z
arena	R7o	a
arend	R8C	a
arendsjong	R8c	o
arendsneus	R9E	w
areopagus	BBG	u
argaïes	R90	g
argaïsme	R+U	m
argentinië	BB0	t
argentyn	BCh	l
argentyns	BDG	0
argeologie	R+6	q
argeologies	R/k	w
argeoloog	SAU	r
argiefbewaarder	SA/	BL
argipel	SCK	i
argitek	SCs	g
argitektuur	SDM	6
argitraaf	SEG	n
argivaris	SEt	+
argon	SFr	Y
argument	SGD	3
argumenteer	SG6	q
argus	BD6	Y
argwaan	SHk	h
argwanend	SIF	o
aria	SIt	c
aries	BES	Y
aristokraat	SJJ	r
aristokrasie	SJ0	u
aristokraties	SKi	x
aristoteles	BEq	w
ariër	BFa	e
ark	BF4	h
ark	SLT	R
arm	SLk	p
armband	SMN	h
arme	SMu	h
armenies	BGZ	j
armenië	BG8	o
armeniër	BHk	p
armhorlosie	SNP	5
armoede	SOI	d
arnika	SOl	b
aroma	SPA	k
aronskelk	SPk	k
arrestant	SQI	0
arrestasie	SQ8	9
arresteer	SR5	h
arrogant	SSa	g
arsenaal	SS6	r
arterie	STl	d
arteriosklerose	SUC	BC
artesies	SVE	i
artikel	SVm	p
artillerie	SWP	l
artilleris	SW0	0
artis	SXo	Z
artisjok	SYB	l
artistiek	SYm	k
artritis	SZK	i
arts	SZs	h
artseny	SaN	6
as	SbH	3
asalea	Sb+	k
asbes	Sci	b
asdag	BIN	g
asem	Sc9	a
asepoestertjie	BIt	0
asepties	SdX	j
asetileen	Sd6	q
aseton	Sek	i
asfalt	SfG	c
asfalteer	Sfi	l
asiaat	BJh	b
asiaties	BJ8	q
asiel	SgH	X
asimmetries	Sge	BJ
asimut	Shn	g
asië	BKm	d
asjoublief	SiH	l
asketies	Sis	g
asma	SjM	6
asmalyer	SkG	7
asmaties	SlB	r
asof	Sls	r
aspek	SmX	4
aspersie	SnP	h
aspidistra	Snw	q
asseblief	Soa	h
assimileer	So7	o
assiries	BLD	g
assirië	BLj	l
assiriër	BMI	m
assisteer	Spj	y
assistensie	SqV	n
assistent	Sq8	BB
assistente	Sr9	y
assuransie	Ssv	l
assureer	StU	g
astekies	BMu	f
aster	St0	Y
asterisk	SuM	k
asteroïde	Suw	q
asteroïed	Sva	o
astrologie	SwC	m
astroloog	Swo	m
astronomie	SxO	m
astronomies	Sx0	4
astronoom	Sys	m
asyn	SzS	a
atavisme	Szs	2
ateljee	S0i	+
ateïs	S1g	d
ateïsme	S19	i
atheens	BNN	f
athene	BNs	x
athener	BOd	h
atlanties	BO+	i
atlantiese	BPg	1
atlas	BQV	Y
atleet	S2f	c
atletiek	S27	h
atleties	S3c	h
atmosfeer	S39	m
atmosferies	S4j	r
atol	S5O	Y
atomies	S5m	e
atoom	S6E	Y
atoombom	S6c	k
atoomenergie	S7A	y
atoomgewig	S7y	t
atrofie	S8f	c
attensie	S87	BA
attent	S97	d
atties	BQt	X
au	S+Y	V
aubade	S+t	f
auditorium	S/M	t
augias	BRE	c
augiasstal	BRg	t
augustus	BSN	u
aula	S/5	c
aurora	BS7	f
australies	BTa	p
australië	BUD	u
australiër	BUx	v
aviateur	TAV	s
avonturier	TBB	o
avontuur	TBp	j
avontuurlik	TCM	s
awend	TC4	c
awendland	BVg	o
aälawa	TDU	5
aërodinamies	TEN	5
aërodinamika	TFG	8
aërostaat	TGC	6
baadjie	TIl	b
baai	TJA	T
baaierd	TJT	k
baaihokkie	TJ3	o
baaiklere	TKf	5
baaikostuum	TLY	8
baak	TMU	X
baal	TMr	V
baan	TNA	CJ
baanbreker	TPJ	n
baantjie	TPw	c
baanveër	TQM	i
baanwagter	TQu	o
baar	TRW	s
baard	TSC	Y
baarmoeder	TSa	p
baars	TTD	X
baas	TTa	x
baat	TUL	/
baatsug	TVK	x
baatsugtig	TV7	5
baatsugtigheid	TW0	BD
baba	TX3	X
bababed	TYO	k
babel	BWI	j
babel	TYy	b
baber	TZN	b
babetjie	TZo	f
babilon	BWr	n
babilonies	BXS	s
babilonië	BX+	q
bacchus	BYo	c
bad	TaH	S
badhokkie	TaZ	m
badhuis	Ta/	f
badkamer	Tbe	k
badklere	TcC	3
badkostuum	Tc5	6
badkuip	Tdz	b
badpak	TeO	x
badplaas	Te/	d
badshuis	Tfc	h
badspons	Tf9	p
bagasie	Tgm	o
bagatel	ThO	i
baie	Thw	Ba
bajonet	TjK	e
bak	1US	q
bak	Tjo	/
bakatel	Tkn	e
bakbaard	TlF	z
bakboord	Tl4	j
bakeliet	Tmb	l
baken	TnA	b
baker	Tnb	2
bakkebaard	ToR	5
bakker	TpK	Z
baklei	Tpj	v
baksteen	TqS	e
bakterie	Tqw	i
bal	TrS	Z
balans	Trr	v
baldakyn	Tsa	v
balderja	TtJ	m
balderjan	Ttv	m
baleare	BZE	s
baleariese	BZw	x
balju	TuV	c
balk	Tux	c
balkan	Bah	c
balkon	TvN	c
ballade	Tvp	o
ballast	TwR	d
ballerina	Twu	BA
ballet	Txu	a
balletdanser	TyI	x
balletdanseres	Ty5	BQ
balling	T0J	b
ballingskap	T0k	m
ballistiek	T1K	n
ballon	T1x	b
balroos	T2M	k
balsem	T2w	u
balties	Ba9	b
baltiese	BbY	i
balustrade	T3e	BM
bamboes	T4q	b
banaal	T5F	w
banaliteit	T51	BO
banana	T7D	i
band	T7l	3
bandiet	T8c	b
bang	T83	W
banjo	T9N	X
bank	T9k	h
banket	T+F	d
bankier	T+i	BM
bankrekening	T/u	BC
bankrot	UAw	6
bankrot	UBq	t
banneling	UCX	g
bannelingskap	UC3	r
bantoe	Bb6	b
bantoe	BcV	Y
baobab	UDi	i
baptis	Bct	c
barak	UEE	1
barbaar	UE5	h
barbaars	UFa	i
barbaarsheid	UF8	8
barbarisme	UG4	q
barbarye	BdJ	k
barbier	UHi	d
bard	UH/	U
bariton	UIT	h
barium	UI0	f
barmhartig	UJT	0
barnsteen	UKH	i
barometer	UKp	o
baron	ULR	Y
barones	ULp	i
baronie	UML	e
barrikade	UMp	o
barrikadeer	UNR	q
barrière	UN7	h
bars	UOc	u
basaar	UQD	q
basalt	UQt	m
basies	URT	a
basiliek	URt	j
basilika	USQ	j
basilikum	USz	k
bask	Bdt	W
basketbal	UTX	o
baskies	BeD	b
baskule	UT/	n
basrelief	UPK	5
bassin	UUm	k
bastion	UVK	g
bataaf	Bee	e
bataljon	UVq	j
bataviaan	Be8	p
batavier	Bfl	o
battery	UWN	+
bauxiet	UXL	e
bazaar	UXp	q
baäl	BgN	Y
beantwoord	UYT	l
beboude	UY4	o
bed	UZg	R
bedaar	UZx	f
bedags	UaQ	BA
bedank	UbQ	BC
bedanking	UcS	0
beddegoed	UdG	x
beddeken	Ud3	h
beddekussing	UeY	q
bedding	UfC	r
bede	Uft	w
bedeel	Ugd	a
bedees	Ug3	z
bedeesheid	Uhq	9
bedehuis	Uin	Bi
bedek	UkJ	Y
bedel	Ukh	X
bedelaar	Uk4	k
bedelares	Ulc	w
bedelary	UmM	n
bedelbroeder	Umz	z
bedelmonnik	Unm	y
bedelorde	UoY	v
bedelry	UpH	k
bedelvrou	Upr	u
bedenking	UqZ	BI
bedenktyd	Urh	v
bederf	UsQ	B7
bederfbaar	UuL	p
bederflik	Uu0	m
bederfweermiddel	Uva	3
bederfwerend	UwR	u
bederwe	Uw/	6
bedevaart	Ux5	q
bedevaartganger	Uyj	4
bedien	Uzb	9
bediende	U0Y	v
bediening	U1H	2
bedil	U19	p
bedilsiek	U2m	k
bedilsug	U3K	o
beding	U3y	BS
bedinging	U5E	5
bedink	U59	0
bedissel	U6x	2
bedkussing	U7n	j
bedlaken	U8K	h
bedlêend	U8r	BF
bedoel	U9w	p
bedoeling	U+Z	y
bedol	U/L	r
bedompig	U/2	4
bedorwe	VAu	5
bedot	VBn	t
bedra	VCU	e
bedrag	VCy	g
bedreig	VDS	o
bedreiging	VD6	t
bedremmeld	VEn	0
bedrewe	VFb	Bz
bedrewenheid	VHO	BT
bedrieg	VIh	BJ
bedrieglik	VJq	BL
bedrieër	VK1	BA
bedrieëry	VL1	p
bedrië	VMe	BP
bedroef	VNt	Bc
bedroefdheid	VPJ	8
bedroewe	VQF	Bf
bedroewend	VRk	t
bedrog	VSR	c
bedruip	VSt	c
bedruk	VTJ	BV
bedruktheid	VUe	BY
bedryf	VV2	CT
bedryfskapitaal	VYJ	9
bedryfsklaar	VZG	1
bedryfsleier	VZ7	t
bedrywe	Vao	BZ
bedrywig	VcB	i
bedrywigheid	Vcj	BP
bedsprei	Vdy	6
bedug	Ves	x
bedugtheid	Vfd	j
beduidenis	VgA	3
bedwing	Vg3	BK
beef	ViB	n
beek	Vio	W
beeld	Vi+	Bc
beeldenaar	Vka	t
beeldend	VlH	g
beelderig	Vln	9
beeldestorm	Vmk	u
beeldestormer	VnS	z
beeldhou	VoF	q
beeldhouer	Vov	n
beeldhouwerk	VpW	u
beeldig	VqE	4
beeldradio	Vq8	x
beeldryk	Vrt	p
beeldskoon	VsW	k
beeldspraak	Vs6	o
beeldstorm	Vti	p
beeldstormer	VuL	u
beeltenis	Vu5	7
been	Vv0	l
beenbreuk	VwZ	v
beenwindsel	VxI	m
beer	Vxu	r
beerklou	VyZ	9
beerwyfie	VzW	o
bees	Vz+	5
beesagtig	V03	s
beesvleis	V1j	g
beet	V2D	f
beetgryp	V2i	/
beethê	V3h	BI
beetkry	V4p	w
beetneem	V5Z	Bm
beetnemery	V6/	x
beetpak	V7w	7
beetsuiker	V8r	4
beetvak	V9j	m
beetvat	V+J	u
bef	V+3	T
befaamd	V/K	e
befaamdheid	V/o	BO
begaaf	WA2	m
begaafdheid	WBc	/
begaan	WCb	Bv
begaanbaar	WEK	1
begeef	WE/	X
begeer	WFW	t
begeerbaar	WGD	o
begeerlik	WGr	l
begeerte	WHQ	Bf
begeester	WIv	j
begeestering	WJS	u
begelei	WKA	v
begeleider	WKv	2
begeleiding	WLl	3
begeleier	WMc	0
begenadig	WNQ	8
begenadiging	WOM	4
begerig	WPE	z
begerigheid	WP3	Ba
begewe	WRR	Z
begiet	WRq	i
begiftig	WSM	y
begin	WS+	BH
beginletter	WUF	n
beginneling	WUs	o
beginner	WVU	h
beginpunt	WV1	q
beginsalaris	WWf	5
beginsel	WXY	x
beginselvas	WYJ	BU
beginselverklaring	WZd	Bp
beginsnelheid	WbG	4
begluur	Wb+	x
begluurder	Wcv	f
begogel	WdO	p
begogelsing	Wd3	BB
begonia	We4	e
begoël	WfW	n
begoëlsing	Wf9	/
begraaf	Wg8	w
begraafplaas	Whs	BD
begraafplek	Wiv	BA
begrafnis	Wjv	2
begrafnisondernemer	Wkl	BL
begrafnisonderneming	Wlw	BN
begrafnisstoet	Wm9	4
begrawe	Wn1	y
begrawing	Won	4
begrens	Wpf	Bd
begrensing	Wq8	2
begrip	Wry	BO
begripsvermoë	WtA	3
begripsverwarring	Wt3	BB
begroei	Wu4	e
begroet	WvW	i
begroeting	Wv4	w
begroot	Wwo	w
begroting	WxY	+
begrotingstekort	WyW	BB
begryp	WzX	q
begrypbaar	W0B	v
begryplik	W0w	s
begryplikerwys	W1c	BR
begryplikerwyse	W2t	BU
begryplikheid	W4B	BM
begunstig	W5N	p
begunstiging	W52	BB
begyn	W63	c
begyntjie	W7T	j
behaag	W72	c
behaaglik	W8S	Bn
behaaglikheid	W95	1
behaagsiek	W+u	n
behaagsug	W/V	l
behaal	W/6	Bm
behaard	XBg	m
behae	XCG	c
behalwe	XCi	BV
behandel	XD3	BS
behandeling	XFJ	q
behang	XFz	s
behanger	XGf	x
behangsel	XHQ	z
behangselpapier	XID	BD
behartig	XJG	k
behartigenswaardig	XJq	BJ
behartiging	XKz	l
beheer	XLY	v
beheers	XMH	Bv
beheerser	XN2	x
beheersing	XOn	y
beheks	XPZ	k
behels	XP9	v
behendig	XQs	9
behendigheid	XRp	BR
behep	XS6	8
behoed	XT2	/
behoedsaam	XU1	u
behoedsaamheid	XVj	w
behoef	XWT	g
behoefte	XWz	i
behoeftig	XXV	q
behoeftigheid	XX/	BT
behoor	XZS	Ba
behoor	XfU	q
behoorlik	Xas	BX
behoorlikheidshalwe	XcD	BJ
behoort	XdM	Bc
behoort	Xeo	s
behou	Xf+	Bc
behoud	Xha	Br
behoudend	XjF	p
behoudenis	Xju	8
behoudens	Xkq	BU
behoudensgesind	Xl+	5
behoue	Xm3	j
behuis	Xna	b
behulpsaam	Xn1	1
behulpsaamheid	Xoq	BJ
beiaard	Xpz	p
beide	Xqc	Y
beier	Bgl	c
beier	Xq0	e
beiere	BhB	e
beiers	Bhf	e
beige	XrS	c
beitel	Xru	j
bejaard	XsR	b
bejammer	Xss	BH
bejammerenswaardig	Xtz	+
bek	Xux	k
bekaf	XvV	x
bekeer	XwG	c
bekeerling	Xwi	w
beken	XxS	3
bekend	XyJ	h
bekendheid	Xyq	BV
bekendmaak	Xz/	BP
bekendmaking	X1O	B0
bekendstel	X3C	BO
bekentenis	X4Q	BH
beker	X5X	a
bekering	X5x	l
bekken	X6W	0
bekkenis	X7K	i
beklaag	X7s	w
beklaagde	X8c	v
beklaaglik	X9L	/
beklad	X+K	0
beklae	X++	u
beklaenswaardig	X/s	BL
beklag	YA3	e
beklag	YCm	d
beklagenswaardig	YBV	BR
beklee	YDD	BH
bekleed	YEK	5
beklemd	YFD	g
beklemde	YFj	t
beklemdheid	YGQ	BC
beklemming	YHS	+
beklemtoon	YIQ	5
beklim	YJJ	p
beklimbaar	YJy	o
beklimming	YKa	3
beklink	YLR	BF
beklouter	YMW	x
beknibbel	YNH	q
beknor	YNx	8
bekoel	YOt	i
bekom	YPP	l
bekommer	YRy	x
bekommerd	YP0	i
bekommering	YQW	t
bekommernis	YRD	v
bekonkel	YSj	j
bekoor	YTG	BA
bekoorlik	YUG	t
bekoorlikheid	YUz	u
bekoring	YVh	y
bekort	YWT	x
bekorting	YXE	o
bekostig	YXs	BT
bekragtig	YY/	BW
bekragtiging	YaV	BO
bekreun	Ybj	Br
bekritiseer	YdO	y
bekrompe	YeA	1
bekroning	Ye1	o
bekroon	Yfd	x
bekruip	YgO	g
bekruis	Ygu	BS
bekryg	YiA	BT
bekwaald	YjT	BK
bekwaam	Ykd	l
bekwaamheid	YlC	p
bel	Ylr	5
belaag	Ymk	l
belaai	YnJ	h
belae	Ynq	j
belaglik	YoN	k
beland	Yox	b
belang	YpM	BR
belangegemeenskap	Yqd	BH
belangeloos	Yrk	x
belangende	YsV	w
belangrik	YtF	u
belangrykheid	Ytz	x
belangstel	YvS	BD
belangstelling	Yuk	u
belangwekkend	YwV	v
belas	YxE	p
belasbaar	Yxt	r
belaster	YyY	h
belasting	Yy5	f
belastingaanslag	YzY	5
belastingbetaler	Y0R	BE
belastingdruk	Y1V	x
belastingjaar	Y2G	z
belastingkantoor	Y25	BH
belastingpligtige	Y4A	BE
belastingstelsel	Y5E	Bb
belastingverhoging	Y6f	BL
belastingverlaging	Y7q	Bd
belastingvermindering	Y9H	Bi
belastingvry	Y+p	+
beledig	Y/n	u
beledigend	ZAV	BW
belediging	ZBr	t
beleef	ZCY	B6
beleefdheid	ZES	6
beleefdheidshalwe	ZFM	BT
beleen	ZGf	q
beleg	ZHJ	BM
belegger	ZIV	h
beleid	ZI2	Bm
beleidvol	ZKc	u
belemmer	ZLK	BV
belemmering	ZMf	BO
belend	ZNt	t
belendend	ZOa	BC
belening	ZPc	i
belese	ZP+	i
belet	ZQg	c
beletsel	ZQ8	y
belewe	ZRu	BW
belewenis	ZTE	o
belewing	ZTs	l
beleë	ZUR	g
beleër	ZUx	d
beleëraar	ZVO	m
beleëring	ZV0	i
belg	Bh9	X
belgies	BiU	c
belgië	Biw	i
belgrado	BjS	j
belhamel	ZWW	p
belief	ZW/	Z
belig	ZXY	k
beliggaam	ZX8	i
beliggaming	ZYe	s
beligting	ZZK	z
beligtingsduur	ZZ9	0
beligtingsmeter	Zax	7
beligtingstyd	Zbs	2
belladonna	Zci	r
belletrie	ZdN	r
beloer	Zd4	z
belofte	Zer	s
beloning	ZfX	w
beloof	ZgH	d
beloon	Zgk	o
belowe	ZhM	f
belroos	Zhr	i
beluister	ZiN	i
beluisteraar	Ziv	u
belus	Zjd	t
belus	ZkK	Y
bely	Zki	a
belydenis	Zk8	p
belê	Zll	BD
belêer	Zmo	h
bemagtig	ZnJ	6
beman	ZoD	W
bemanning	ZoZ	f
bemantel	Zo4	e
bemeester	ZpW	z
bemerk	ZqJ	b
bemes	Zqk	c
bemesting	ZrA	9
bemiddel	Zr9	l
bemiddelaar	Zsi	o
bemiddeld	ZtK	BA
bemiddeling	ZuK	p
bemin	Zuz	X
beminde	ZvK	BN
beminlik	ZwX	h
beminlikheid	Zw4	v
beminnaar	Zxn	h
beminnenswaardig	ZyI	1
beminnenswaardigheid	Zy9	BC
bemisting	Zz/	9
bemodderd	Z08	v
bemoedig	Z1r	h
bemoediging	Z2M	s
bemoeial	Z24	q
bemoeienis	Z3i	l
bemoeigees	Z4H	r
bemoeilik	Z4y	x
bemoeisiek	Z5j	l
bemoeisug	Z6I	p
bemoeisugtig	Z6x	s
benaam	Z7d	a
benadeel	Z73	5
benader	Z8w	0
benadruk	Z9k	5
benaming	Z+d	t
benard	Z/K	x
benardheid	Z/7	BD
bende	aA+	j
benede	aBh	0
benedebuur	aCV	9
benedebuurman	aDS	BE
benedeloop	aEW	w
benedeverdieping	aFG	8
benediktyner	Bj1	BG
benediktynermonnik	Bk7	BV
benedy	aGC	e
beneem	aGg	o
benefice	aHI	2
beneficevoorstelling	aH+	BL
benelux	BmQ	h
benepe	aJJ	2
benepenheid	aJ/	BC
benewel	aLB	q
beneweld	aLr	g
benewens	aML	o
bengaals	Bmx	h
bengaalse	BnS	9
bengale	BoP	h
benodig	aMz	j
benodigdhede	aNW	BL
benoem	aOh	v
benoeming	aPQ	9
benoorde	aQN	g
benou	aQt	i
benoud	aRP	Bv
benouend	aS+	B3
benseen	aU1	e
bensien	aVT	v
bensienreservoir	aWC	BL
bensine	aXN	x
bensinereservoir	aX+	BK
benul	aZI	4
benut	aaA	BP
benuttig	abP	BV
beny	ack	X
beoefen	ac7	l
beoefenaar	adg	s
beoefening	aeM	l
beoog	aex	f
beoordeel	afQ	7
beoordelaar	agL	r
beoordeling	ag2	s
beoorlog	ahi	BX
beoorloog	ai5	Ba
beooste	akT	9
beosië	Bow	k
bepaal	alQ	DA
bepalend	aoQ	x
bepaling	apB	Bt
bepantser	aqu	i
bepantsering	arQ	p
beperk	ar5	2
beperkend	asv	n
beperking	atW	z
beplan	auJ	Z
beplant	aui	c
beplanting	au+	y
bepleister	avw	m
bepleit	awW	n
beploe	aw9	Z
beploege	axW	e
beploë	ax0	e
bepoeier	ayS	f
bepraat	ayx	u
beproef	azf	9
beproewe	a0c	BA
beproewing	a1c	m
beraadslaag	a2C	s
beraadslaging	a2u	BC
beraam	a3w	t
beraming	a4d	x
berberis	a5O	k
beredder	a5y	BO
berede	a7A	e
beredeneer	a7e	BI
bereg	a8m	x
beregting	a9X	BB
berei	a+Y	o
bereid	a/A	u
bereiding	a/u	o
bereidvaardig	bAW	BK
bereidwillig	bBg	x
bereik	bCR	BJ
bereikbaar	bDa	q
bereisd	bEE	1
bereken	bE5	BI
berekening	bGB	6
bereklou	bG7	v
beremus	bHq	v
berg	bIZ	Y
bergagtig	bIx	n
bergamot	bJY	m
bergbeklimmer	bJ+	BW
bergengte	bLU	y
berghelling	bMG	u
berging	bM0	z
bergingsmaatskappy	bNn	BD
bergkam	bOq	l
bergklimmer	bPP	BP
bergkristal	bQe	w
bergloon	bRO	w
berglug	bR+	j
bergmuis	bSh	g
bergpik	bTB	e
bergpunt	bTf	+
bergreeks	bUd	BT
bergrug	bVw	l
bergspits	bWV	BA
bergtop	bXV	8
berig	bYR	Bs
beril	bZ9	Y
berilsteen	baV	j
berin	ba4	d
berispe	bbV	BE
berisping	bcZ	BH
berk	bdg	V
berkeboom	bd1	k
berlyn	BpU	d
berlyner	Bpx	k
berlyns	BqV	f
berlynsblou	beZ	w
berm	bfJ	w
bern	Bq0	V
beroemd	bf5	q
beroemdheid	bgj	BE
beroep	bhn	BL
beroeps	biy	k
beroer	bjW	BQ
beroerd	bkm	BZ
beroering	bl/	w
beroerte	bmv	BS
berokken	boB	2
beroof	bo3	3
berooid	bpu	n
berou	bqV	e
beroue	bqz	BF
berouhebbend	br4	BA
berouvol	bs4	4
berowe	btw	b
berower	buL	g
berowing	bur	j
berrie	bvO	b
berug	bvp	g
beruik	bwJ	n
berus	bww	s
berusting	bxc	1
bery	byR	o
berybaar	by5	y
berym	bzr	a
beryp	b0F	i
besadig	b0n	Ba
beseer	b2B	Z
besef	b2a	CD
besem	b4d	Z
beset	b42	y
besete	b5o	v
besetene	b6X	j
besetenheid	b66	BJ
besetting	b8D	0
beseël	b83	BC
beseëling	b95	l
besie	b+e	Z
besiel	b+3	a
besield	b/R	h
besielend	b/y	j
besieling	cAV	BA
besien	cBV	W
besienswaardig	cBr	y
besig	cCd	Y
besigheid	cC1	0
besighou	cDp	5
besinning	cEi	z
besit	cFV	6
besitting	cGP	v
beskaaf	cG+	2
beskaafdheid	cH0	9
beskaam	cIx	k
beskaamd	cJV	h
beskaamtheid	cJ2	p
beskadig	cKf	x
beskadiging	cLQ	p
beskadu	cL5	m
beskaduwee	cMf	v
beskamend	cNO	p
beskawe	cN3	4
beskawing	cOv	q
beskeid	cPZ	7
beskeidenheid	cQU	w
beskeie	cRE	BG
beskerm	cSK	u
beskermeling	cS4	s
beskermengel	cTk	x
beskermer	cUV	i
beskermheer	cU3	o
beskermheilige	cVf	z
beskerming	cWS	o
beskermling	cW6	r
beskiet	cXl	1
beskieting	cYa	i
beskik	cY8	k
beskikbaar	cZg	o
beskikking	caI	Bh
beskilder	cbp	m
beskimmel	ccP	l
beskimmeld	cc0	j
beskimp	cdX	r
beskinder	ceC	j
beskindering	cel	/
beskonke	cfk	t
beskonkenheid	cgR	/
beskrywing	chQ	0
beslis	ciE	5
besluit	ci9	d
besoedel	cja	c
besoek	cj2	Y
besoeker	ckO	n
besoekersboek	ck1	1
besonderheid	clq	r
bespaar	cmV	j
bespreek	cm4	r
bespreking	cnj	m
bestaan	coJ	d
beste	com	X
besteding	co9	l
bestel	cpi	p
bestelling	cqL	i
bestudeer	cqt	g
bestuur	crN	BH
bestuurder	csU	0
beswaar	ctI	f
betaal	ctn	Z
betaam	cuA	n
beteken	cun	t
betekenis	cvU	l
betekenisvol	cv5	y
beter	cwr	a
betlehem	BrJ	h
betrekking	cxF	h
betrokke	cxm	v
betyds	cyV	x
beuk	czG	W
bevat	czc	t
bevestig	c0J	BZ
bevolking	c1i	m
bevorder	c2I	q
bevordering	c2y	q
bevrore	c3c	g
bevrug	c38	p
bewaar	c4l	4
beweeg	c5d	i
beweging	c5/	j
bewering	c6i	w
bewonder	c7S	f
bewys	c7x	n
beëindig	c8Y	+
beëindiging	c9W	BD
beërf	c+Z	b
beërwe	c+0	e
beïndruk	c/S	i
beïnvloed	c/0	x
biblioteek	dAl	p
bibliotekaris	dBO	2
bid	dCE	S
bieg	dCW	m
bier	dC8	Z
bikini	dDV	a
biljart	dDv	g
billik	dEP	p
bind	dE4	w
binne	dFo	2
binnekort	dGe	h
binnelands	dG/	z
bioskoop	dHy	w
birma	Brq	Y
birmaan	BsC	f
birmees	Bsh	e
bisantium	Bs/	m
bisantyns	Btl	m
biskop	dIi	b
bismut	dI9	c
bison	dJZ	g
bitter	dJ5	j
blaarslaai	dKc	l
blaas	dLB	X
bladsy	dLY	b
blank	dLz	Y
blanke	dML	p
bleik	dM0	i
blik	dNW	h
blind	dN3	X
blink	dOO	k
bloed	dOy	V
bloedrooi	dPH	v
bloedverwant	dP2	q
bloemfontein	BuL	v
bloese	dQg	Z
blok	dQ5	a
blokletter	dRT	h
blom	dR0	d
blou	dSR	V
bloubaard	Bu6	m
blus	dSm	j
bly	dTJ	5
bo	dUC	6
bobbejaan	dU8	i
boeddha	Bvg	b
boeddhisme	Bv7	i
boeddhist	Bwd	f
boek	dVe	S
boekarest	Bw8	l
boekhou	dVw	w
boer	Bxh	v
boer	dWg	g
boereplaas	dXA	+
boesman	ByQ	c
boete	dX+	V
boetekaartjie	dYT	0
bogenoemd	dZH	2
boheems	Bys	e
boheme	BzK	d
boks	dZ9	T
bokser	daQ	a
boliwies	Bzn	j
boliwië	B0K	o
bolsjewiek	B0y	o
bolsjewis	B1a	o
bombaai	B2C	d
bondel	daq	y
bonus	dbc	a
boodskap	db2	p
boom	dcf	V
boonop	dc0	f
boor	ddT	V
boord	ddo	a
bord	deC	V
bordeel	deX	e
bors	de1	k
borsel	dfZ	a
bos	dfz	b
bosbok	dgO	d
bots	dgr	X
botsing	dhC	g
bottel	dhi	a
botter	dh8	a
bouer	diW	b
braai	dix	t
brabander	B2f	o
brabant	B3H	g
brabants	B3n	l
brand	dje	w
brandewyn	dkO	m
brandstof	dk0	f
brasiliaan	B4M	q
brasiliaans	B42	s
brasilië	B5i	m
breek	dlT	X
breekbaar	dlq	3
brein	dmh	Y
bretagne	B6I	t
brief	dm5	W
briefkaart	dnP	k
bril	dnz	j
bring	doW	e
brinjal	do0	BC
brit	B61	W
brits	B7L	Z
broei	dp2	e
broer	dqU	Z
broerskind	dqt	v
bron	drc	o
brons	dsE	Y
brood	dsc	e
brosjure	ds6	1
brug	dtv	W
bruin	duF	X
brunswyk	B7k	k
brussel	B8I	e
brussels	B8m	g
brusselse	B9G	t
buffel	duc	b
buffer	du3	i
buig	dvZ	U
buis	dvt	r
buite	dwY	m
buiteland	dw+	t
bul	dxr	S
bulgaar	B9z	o
bulgaars	B+b	i
bulgarye	B+9	k
bundel	dx9	f
burger	dyc	BE
buro	dzg	g
bus	d0A	j
bushalte	d0j	w
buurman	d1T	e
by	d1x	BH
by	d90	i
bybel	B/h	a
bybel	d24	a
bylae	d3S	n
bymekaar	d35	n
bymekaarbring	d4g	BU
byna	d50	h
bynaam	d6V	z
byt	d7I	U
byvoeg	d7c	Y
bywoon	d70	z
bywoord	d8n	g
bywoordelik	d9H	t
bêre	d+W	BU
bêreplek	d/q	BI
caesar	B/7	Z
calvyn	CAU	d
carthager	CAx	q
carthago	CBb	j
casino	eAy	f
celebes	CB+	h
ceylon	CCf	a
chaos	eBR	h
chemie	eBy	c
chileen	CC5	c
chileens	CDV	e
chili	CDz	V
china	CEI	X
chinees	CEf	s
chirurg	eCO	e
chloor	eCs	c
christelik	CFL	m
christen	CFx	h
christendom	CGS	t
christus	CG/	e
cipries	CHd	l
ciprioot	CIC	i
ciprus	CIk	a
columbus	CI+	m
confucius	CJk	m
curaçao	CKK	n
daad	eDI	+
daag	eEG	X
daagliks	eEd	f
daal	eE8	s
daar	eFo	q
daar	eKF	o
daardie	eGS	b
daarmee	eGt	f
daarna	eHM	2
daarom	eIC	w
daarso	eIy	d
daarvandaan	eJP	2
dadelik	eKt	Bs
dag	eMZ	d
dagvaarding	eM2	o
damestudent	eNe	7
dan	eOZ	S
dank	eOr	W
dankbaar	ePB	j
dankie	ePk	l
danksy	eQJ	h
dans	eQq	X
dapperheid	eRB	n
dardanelles	CKx	7
darem	eRo	BO
das	eS2	a
dat	eTQ	S
dateer	eTi	Z
datum	eT7	Z
deeglik	eUU	s
deel	eVA	l
deelneem	eVl	2
deels	eWb	j
deen	CLs	U
deens	CMA	Y
definisie	eW+	m
definitief	eXk	BD
deftig	eYn	2
dek	eZd	T
dekade	eZw	e
deken	eaO	b
dekor	eap	m
delikaat	ebP	5
demokrasie	ecI	n
demokraties	ecv	q
den	edZ	p
denemarke	CMY	n
denneboom	eeC	8
departement	ee+	r
deponeer	efp	j
deporteer	egM	l
derde	egx	a
dertien	ehL	d
dertig	eho	b
desember	CM/	j
destyds	eiD	d
detail	eig	d
deur	ei9	+
deurbring	ej7	n
deurdat	eki	0
deurmaak	elW	Ba
deurmekaar	emw	5
deurpad	enp	BK
deursnee	eoz	h
deuteronomium	CNi	6
diamant	epU	e
die	epy	P
die	eta	Z
die	etz	S
die	euF	U
die	euZ	T
dieet	eqB	W
dief	eqX	T
diens	eqq	X
diep	erB	c
diepte	erd	Y
dier	er1	i
dieretuin	esX	h
dieselfde	es4	i
digter	eus	Z
dikwels	evF	z
dimensie	ev4	u
dinee	ewm	m
ding	exM	9
dink	eyJ	s
dinsdag	COc	e
diploma	ey1	h
direk	ezW	i
direkteur	ez4	t
dissipline	e0l	n
dit	e1M	BN
dit	e2Z	q
dit	e3D	k
dié	e3n	d
doel	e4E	o
doen	e4s	t
dogter	e5Z	1
dokter	e6O	m
dokument	e60	q
dom	e7e	l
dominee	e8D	g
dominikaans	CO6	p
donasie	e8j	n
donau	CPj	Z
donderdag	CP8	l
donker	e9K	7
donkie	e+F	f
dood	e+k	h
doodmaak	e/F	u
doodskiet	e/z	k
doof	fAX	V
doop	fAs	l
doopnaam	fBR	p
doos	fB6	U
dor	fCO	R
dories	CQh	i
dorp	fCf	X
dors	fC2	X
dors	fDN	a
dosyn	fDn	Z
dra	fEA	b
draagbaar	fEb	9
draai	fFY	W
dragtig	fFu	r
drakensberge	CRD	9
drama	fGZ	a
dreigement	fGz	v
drie	fHi	T
driekoninge	CSA	6
driekoningefees	CS6	BI
dringend	fH1	p
drink	fIe	p
drinkpan	fJH	i
dromedaris	fJp	v
dronk	fKY	l
droog	fK9	W
droogte	fLT	f
druif	fLy	X
druk	fMJ	n
drup	fMw	U
dryf	fNE	Bo
duidelik	fOs	h
duim	fPN	V
duisend	fPi	t
duister	fQP	g
duits	CUC	u
duitse	CVN	j
duitse	CVw	s
duitser	CUw	d
duitsland	CWc	i
duiwel	fQv	a
dun	fRJ	z
durf	fR8	X
dus	fST	/
duur	fTS	8
dwarsdeur	fUO	u
dwerg	fU8	r
dwing	fVn	f
edel	fWG	X
edelweiss	fWd	p
eden	CW+	W
edenburg	CXU	m
eed	fXG	S
eekhoring	fXY	m
eekhorinkie	fX+	s
een	fZj	R
een	fdC	a
eend	fZ0	U
eendag	faI	x
eenentwintig	fYq	5
eenheid	fa5	o
eensaam	fbh	o
eensaamheid	fcJ	5
eergister	fdc	0
eerlik	feQ	q
eers	fe6	BP
eerskomende	fgJ	BK
eerste	fhT	a
eetkamer	fht	p
eetservies	fiW	q
eeu	fjA	h
effek	fjh	j
effektief	fkE	k
egeïese	CX6	t
eggenoot	fko	j
eggo	flL	T
egipte	CYn	c
egiptenaar	CZD	r
egipties	CZu	h
egter	fle	y
ei	fmQ	Q
eie	fmg	d
eienaar	fm9	h
eienaardig	fne	BF
eiendomsagentskap	foj	6
eierplant	fpd	w
eiervrug	fqN	5
eik	frG	S
eiland	frY	c
einde	fr0	f
eindeksamen	fsT	5
eindig	ftM	Bd
eintlik	fup	p
ekonomies	fvS	m
eksamen	fv4	6
eksodus	CaP	g
eksperiment	fwy	s
ekstase	fxe	h
ekstra	fx/	m
ekstreem	fyl	8
eland	fzh	q
elders	f0L	e
elegant	f0p	f
elegie	f1I	Z
elektries	f1h	h
elektrisiteit	f2C	x
elektron	f2z	h
elementêr	f3U	1
elf	f4J	e
els	f4n	T
elsasies	Cav	i
elsasser	CbR	h
elsboom	f46	d
emigreer	f5X	i
emosie	f55	s
en	f6l	P
energie	f60	c
engeland	Cby	j
engels	CcV	z
engelsman	CdI	z
enige	f7Q	+
enige	f8O	q
enigiemand	f84	BX
enigiets	f+P	u
enigste	f+9	0
enkele	f/x	n
enorm	gAY	y
ens	gBK	h
ensovoorts	gBr	3
erediens	gCi	z
erf	gDV	V
erg	gDq	g
erken	gEK	0
ernstig	gE+	r
ertjie	gFp	V
ervare	gF+	BA
ervaring	gG+	m
esel	gHk	d
eskimo	Cd7	a
esperantis	gIB	s
esperanto	CeV	n
est	Ce8	W
estland	CfS	e
ests	Cfw	Y
ete	gIt	U
ethiopië	CgI	3
ethiopiër	Cg/	t
etruries	Chs	r
etrurië	CiX	m
etruriër	Ci9	x
etruskies	Cju	u
eufraat	Ckc	i
europa	Ck+	s
europeaan	Clq	q
europees	CmU	l
europese	Cm5	1
europeër	Cnu	m
eva	CoU	T
evolusie	gJB	w
ewe	gJx	Bu
ewig	gLf	x
fabriek	gMQ	c
familie	gMs	b
familielid	gNH	m
fase	gNt	f
fasiliteer	gOM	o
fassineer	gO0	l
februarie	Con	n
fee	gPZ	T
feit	gPs	V
feodaal	gQB	k
ferm	gQl	y
fiets	gRX	k
fietsry	gR7	c
fiks	gSX	d
filippyns	CpO	n
filistyn	Cp1	m
film	gS0	t
fin	Cqb	S
finland	Cqt	e
finlander	CrL	g
fins	Crr	X
firma	gTh	g
flard	gUB	c
fliek	gUd	y
fliekhuis	gVP	u
flikker	gV9	l
floreer	gWi	r
flou	gXN	d
fluit	gXq	X
fonds	gYB	W
fooitjie	gYX	Z
forel	gYw	X
formeel	gZH	d
fossiel	gZk	a
foto	gZ+	c
fout	gaa	r
framboos	gbF	j
frankeland	CsC	r
frankies	Cst	g
frankryk	CtN	i
frans	Ctv	w
franse	Cuf	u
fries	CvN	X
friesland	Cvk	i
funksie	gbo	e
gaaf	gcG	3
gaan	gc9	T
gaan	gdQ	r
gade	gd7	X
galery	geS	f
galicies	CwG	f
gallië	Cwl	e
gans	gex	V
garage	gfG	f
garnaal	gfl	d
gas	ggC	d
gasvry	ggf	h
gasvryheid	ghA	u
gat	ghu	S
geadresseerde	giA	u
geag	giu	V
gebed	gjD	Z
gebeur	gjc	v
gebeurtenis	gkL	BY
gebied	glj	k
geboorte	gmH	g
gebou	gmn	c
gebruik	gnD	BI
gebruiker	goL	g
gedaante	gor	m
gedagte	gpR	f
gedeelte	gpw	v
gedeeltelik	gqf	y
gedek	grR	n
gedig	gr4	X
gedra	gsP	s
geduld	gs7	d
geduldig	gtY	h
gedurende	gt5	/
gee	gu4	S
geel	gvK	W
geen	gvg	S
gees	gvy	BP
geesdrif	gxB	t
geesdriftig	gxu	s
geheim	gya	c
gehoorsaam	gy2	k
geld	gza	V
geldstuk	gzv	d
geleentheid	g0M	BG
geliefde	g1S	BS
geluk	g2k	n
gelukkig	g30	x
gelukkig	g3L	p
gelykheid	g4l	t
gemiddeld	g5S	w
genealogie	g6C	/
genealogies	g7B	u
genealoog	g7v	p
geneig	g8Y	e
generaal	g82	i
generasie	g9Y	n
genesis	CxD	g
geneve	Cxj	k
geniet	g9/	7
genoeg	g+6	l
genot	g/f	g
genre	g//	b
gent	CyH	V
genua	Cyc	a
geografies	hAa	3
geparenteer	hBR	7
geraamte	hCM	j
gereed	hCv	t
geregtigheid	hDc	7
gereëld	hEX	h
gerieflik	hE4	l
germaan	Cy2	m
germaans	Czc	s
geruime	hFd	6
gerus	hGX	m
gesag	hG9	8
gesels	hH5	g
gesig	hIZ	o
gesin	hJB	Z
gesins	hJa	g
geskei	hJ6	e
geskenk	hKY	l
geskie	hK9	s
geskiedenis	hLp	t
geskikt	hMW	Br
geskoolde	hOB	h
geslag	hOi	p
geslaglys	hPL	o
geslagregister	hPz	0
gesond	hQn	i
gesondheid	hRJ	l
gespanne	hRu	h
gesprek	hSP	j
getroud	hSy	f
geur	hTR	q
geveg	hT7	0
gevolglik	hUv	BP
gevolgtrekking	hV+	7
geweldig	hW5	x
gewete	hXq	h
gewig	hYL	Z
gewild	hYk	c
gewoon	hZA	t
gewoond	hZt	0
gewoonlik	hah	w
gewoonte	hbR	t
geïnteresseerd	hb+	5
gholf	hc3	W
gids	hdN	q
gier	hd3	X
giet	heO	h
giftig	hev	e
gil	hfN	S
gimnastiek	hff	m
ginder	hgF	s
ginds	hgx	p
gister	hha	e
glad	hh4	a
glas	hiS	V
gleuf	hin	X
glimlag	hi+	c
glo	hja	w
gly	hkK	b
god	C0I	R
god	hkl	R
godsdiens	hk2	h
godsdienstig	hlX	1
goed	hmM	p
goedkoop	hm1	q
goeie	C0Z	d
goeiemiddag	hnf	v
goeiemôre	hoO	t
goeienaand	ho7	s
goeienag	hpn	l
gooi	hqM	V
gordyn	hqh	e
goties	C02	b
gou	hq/	l
gou	huD	j
goud	hrk	V
goudgeel	hr5	n
goudkus	C1R	i
goudmyn	hsg	l
goudvis	htF	g
goue	htl	e
graad	hum	1
graag	hvb	c
graal	C1z	Y
gram	hv3	c
grammatika	hwT	k
gras	hw3	V
grasgroen	hxM	k
gratis	hxw	b
grens	hyL	s
gretig	hy3	w
griek	C2L	V
griekeland	C2g	k
grieks	C3E	x
griep	hzn	k
grimeer	h0L	e
grimering	h0p	v
groen	h1Y	V
groenland	C31	i
groente	h1t	e
groep	h2L	V
groet	h2g	s
grond	h3M	g
grondwet	h3s	l
groot	h4R	k
grootbrittanje	C4X	BD
grootmoeder	h41	q
grootouers	h5f	s
grootte	h6L	0
grootvader	h6/	s
grot	h7r	u
groutjie	h8Z	i
gryp	h87	y
grys	h9t	W
guinee	C5a	b
gulde	C51	g
gunsteling	h+D	5
haai	h+8	V
haalbaar	h/R	l
haan	h/2	e
haar	iAU	5
haarkapper	iBN	x
haas	iB+	5
haastig	iC3	BH
haat	iD+	V
hael	iET	V
hakie	iEo	9
halfbroer	iFl	p
halfsuster	iGO	r
hallo	iG5	b
hals	iHU	U
hamburger	iHo	m
hand	iIO	U
handel	iIi	u
handelaar	iJQ	5
handlanger	iKJ	8
handtekening	iLF	s
hang	iLx	b
hanteer	iMM	p
hap	iM1	e
hard	iNT	U
hardloop	iNn	d
hare	iOE	p
hart	iOt	V
havanna	C6V	h
hawaiï	C62	c
hawaïes	C7S	h
hawe	iPC	o
haïti	C7z	c
hebreeus	C8P	m
hebreër	C81	i
hebride	C9X	w
heelal	iPq	d
heeltemal	iQH	9
heerlik	iRE	BT
heide	iSX	Z
heilig	iSw	e
heks	iTO	V
hel	iTj	S
held	iT1	U
helder	iUJ	/
heldhaftig	iVI	k
heldin	iVs	c
hele	iWI	o
helleens	C+H	s
hellespont	C+z	3
helm	iWw	W
help	iXG	4
helvesië	C/q	r
hemel	iX+	f
hemelvaartdag	DAV	2
hemp	iYd	V
hen	iYy	b
hengel	iZN	g
hengelaar	iZt	l
herdenking	iaS	r
herder	ia9	d
herfs	iba	Y
herhaal	iby	e
herinnering	icQ	0
herkoms	idE	r
heroïen	idv	e
heroïne	ieN	h
hert	ieu	U
heuning	ifC	d
heup	iff	U
hierbo	ifz	c
hierdie	igP	j
hierheen	igy	v
hiervandaan	ihh	z
higiënies	iiU	j
hindoe	DBL	a
hindoe	DBl	X
hindoes	DB8	Z
hings	ii3	a
hitte	ijR	W
hiëna	ijn	e
hoe	io9	V
hoe	ioV	o
hoe	ipS	T
hoed	ikF	R
hoekom	ikW	r
hoender	ilB	r
hoer	ils	b
hoerhuis	imH	e
hoes	iml	T
hoeveel	im4	s
hoeveelste	ink	x
hof	ipl	T
hok	ip4	S
hokkie	iqK	Y
holland	DCV	d
hollander	DCy	u
hollands	DDg	d
hom	iq7	c
hom	iqi	Z
hom	irX	s
hond	isD	T
honderd	isW	q
hongaar	DD9	i
hongaars	DEf	k
hongarye	DFD	l
honger	itA	b
honger	itb	e
hoofkwartier	it5	x
hoofpyn	iuq	i
hoofsaaklik	ivM	BV
hoofstad	iwh	BA
hoofweg	ixh	i
hooglander	DFo	p
hooglied	DGR	BB
hoop	iyD	V
hoor	iyY	u
horlosie	izG	f
horror	izl	a
hospitaal	iz/	m
hotel	i0l	X
hou	i08	e
hou	i30	f
houding	i1a	Bb
houer	i21	i
hout	i3X	d
huidig	i4T	8
huis	i5P	V
huis	i5k	U
huldig	i54	i
hulle	i6a	7
hulle	i7V	Y
hulp	i7t	Z
hurk	i8G	k
huur	i8q	S
huurmotor	i88	g
huwelik	i9c	q
hy	i+G	V
hyser	i+b	j
hê	i++	c
iberies	DHS	d
ideaal	i/a	a
idee	i/0	U
idioom	jAI	a
iemand	jAi	BK
iep	jBs	P
ier	DHv	U
ierland	DID	c
iers	DIf	T
iets	jB7	h
ignoreer	jCc	5
immigreer	jDV	k
immoreel	jD5	q
impak	jEj	q
in	jFN	w
in	jjD	g
in	jjj	i
in	jk+	V
in	jkF	5
in	jlT	U
in	jln	o
in	jmP	Y
in	jmn	k
in	jnL	u
inasem	jF9	g
inbreker	jGd	i
indeks	jG/	a
indiaan	DIy	v
indiaans	DJh	s
indien	jHZ	k
indies	DKN	Z
indiese	DKm	b
individueel	jH9	r
indië	DLB	e
indiër	DLf	f
indochina	DL+	t
indoeuropeaan	DMr	BA
indoeuropees	DNr	BR
indoeuropeër	DO8	8
indogermaans	DP4	BJ
indonesies	DRu	n
indonesië	DSV	s
indonesiër	DTB	t
indosjina	DRB	t
indruk	jIo	n
industrie	jJP	k
ineenkrimp	jJz	s
informasie	jKf	4
ingenieur	jLX	j
inheems	jL6	4
inhoud	jMy	e
inleiding	jNQ	y
inlewer	jOC	BV
inligting	jPX	w
inligtingskantoor	jQH	BD
inmaak	jRK	e
innig	jRo	+
inrigting	jSm	l
inruil	jTL	m
insameling	jTx	r
insident	jUc	BB
insig	jVd	t
insit	jWK	9
inskep	jXH	c
insluitend	jXj	0
inspekteur	jYX	o
inspektisto	jY/	p
inspuit	jZo	d
inspuiting	jaF	n
instel	jas	r
instituut	jbX	j
instruksie	jb6	z
inteendeel	jct	4
intelligent	jdl	4
intens	jed	u
interessant	jfL	r
internasionaal	jf2	2
intusse	jgs	BT
invoer	jh/	b
invul	jia	p
ionies	DTu	b
iraaks	DUJ	k
irak	DUt	U
irakiër	DVB	q
iran	DVr	c
iranies	DWH	c
iraniër	DWj	r
islam	DXO	X
islamities	DXl	i
isolasie	jn5	z
israel	DYH	d
israeli	DYk	v
israelies	DZT	x
israeliet	DaE	1
israelities	Da5	0
istanboel	Dbt	k
italiaan	DcR	h
italiaans	Dcy	j
italianer	DdV	l
italië	Dd6	d
item	jos	x
ivoor	jpd	Y
ja	jp1	R
jaag	jqG	s
jaar	jqy	V
jaarliks	jrH	o
jag	jrv	T
jager	jsC	b
jakkals	jsd	c
jaloers	js5	e
jamaika	DeX	f
jammer	jtX	0
jammer	juL	q
januarie	De2	j
japan	DfZ	Y
japannees	Dfx	j
japanner	DgU	h
japans	Dg1	d
jas	ju1	c
java	DhS	X
javaan	Dhp	e
javaans	DiH	n
jeens	jvR	Bk
jehova	Diu	f
jerusalem	DjN	l
joernalis	jw1	k
johannesburg	Djy	v
jongmens	jxZ	q
jonk	jyD	W
jood	Dkh	c
joods	Dk9	Z
jordaan	DlW	e
josef	Dl0	b
josie	jyZ	Y
jou	jyx	2
joune	jzn	Z
juis	j0A	BF
julie	DmP	U
julle	j15	X
julle	j1F	0
junie	Dmj	U
juweel	j2Q	e
juwelier	j2u	h
jy	j3/	X
jyenjou	j3P	w
kaap	Doi	i
kaapprovinsie	Dm3	x
kaaps	Dno	X
kaapstad	Dn/	j
kaart	j4W	W
kaartjie	j4s	p
kaartjieskantoor	j5V	8
kabeljou	j6R	p
kabinet	j66	e
kafeteria	j7Y	n
kain	DpE	U
kalifornië	DpY	v
kalkoen	j7/	b
kalm	j8a	s
kalmeer	j9G	6
kalvarieberg	DqH	3
kam	j+A	S
kameel	j+S	a
kameelperd	j+s	l
kamer	j/R	i
kamera	j/z	e
kameroen	Dq+	i
kamp	kAR	BN
kampeer	kBe	BA
kampeerterrein	kCe	BF
kan	kDj	Y
kanaal	kD7	k
kanada	Drg	c
kanadees	Dr8	i
kanaries	Dse	g
kanariese	Ds+	r
kandidaat	kEf	k
kangeroe	kFD	i
kanker	kFl	k
kans	kGJ	e
kanselleer	kGn	BM
kant	kHz	U
kantoor	kIH	r
kantoorklerk	kIy	o
kapitool	Dtp	l
kapster	kJa	2
kaptein	kKQ	f
kar	kKv	l
karakter	kLU	4
karig	kMM	0
karma	kNA	Y
karmeliet	DuO	m
karpate	Du0	7
kas	kNY	y
kaspiese	Dvv	j
kasset	kOK	c
kasteel	kOm	d
kastiliaans	DwS	s
kat	kPD	R
katalogus	kPU	y
katoliek	kQG	f
katolisisme	kQl	w
kaukasus	Dw+	n
kaïro	Dxl	Y
keel	kRV	W
keer	kRr	v
kelder	kSa	l
kelkie	kS/	b
kelner	kTa	b
kelt	Dx9	U
kelties	DyR	o
ken	kT1	m
kenia	Dy5	b
kenmerkend	kUb	s
kennis	kVH	w
kennisgewing	kV3	B+
kerk	kX1	v
kerrie	kYk	X
kers	kY7	W
kersboom	kZR	o
kersfees	DzU	+
kersmis	D0S	x
kersvader	D1D	u
keulen	D1x	d
keuse	kZ5	k
kies	kad	l
kiesel	kbC	a
kilogram	kbc	e
kilometer	kb6	n
kind	kch	7
kla	kdc	Y
klaar	kd0	BG
klank	ke6	Y
klap	kfS	i
klaploper	kf0	3
klas	kgr	V
klassiek	khA	o
klavier	kho	c
klee	kiE	d
kleefband	kih	o
klein	kjJ	s
kleinasië	D2O	1
kleindogter	kj1	u
kleingeld	kkj	i
kleinkind	klF	n
kleinseun	kls	l
klere	kmR	l
klets	km2	Y
kleur	knO	p
kleuterskool	kn3	0
kliek	kor	2
klik	kph	j
klim	kqE	V
klimaat	kqZ	f
kliniek	kq4	b
klink	krT	Y
kliënt	krr	l
klokkie	ksQ	v
klomp	ks/	BM
kloof	kuL	Z
klub	kuk	d
knie	kvB	S
knip	kvT	U
knoop	kvn	d
kobalt	kwE	d
kobra	kwh	a
kode	kw7	X
koei	kxS	S
koel	kxk	S
koepee	kx2	m
koerant	kyc	BY
koeël	kz0	Y
koffer	k0M	Z
koffie	k0l	Y
kollega	k09	g
kollege	k1d	d
kolom	k16	g
kolonie	k2a	p
kom	k3D	S
kombinasie	k3V	r
kombuis	k4A	e
komedie	k4e	c
komhalertjie	k46	w
kommandant	k5q	m
kommentaar	k6Q	u
kommissie	k6+	g
kompak	k7e	c
kompartement	k76	4
kompetisie	k8y	y
koms	k9k	X
kondukteur	k97	k
koneksie	k+f	m
kongo	D3D	g
koning	k/F	b
koninkryk	k/g	q
konsep	lAK	BD
konsert	lBN	e
konstantinopel	D3j	z
konsternasie	lBr	3
konsul	lCi	b
kontak	lC9	c
kontant	lDZ	k
kontrak	lD9	f
kontrole	lEc	2
kontroleer	lFS	BJ
konyn	lGb	a
kook	lG1	g
koors	lHV	e
koorsig	lHz	g
kop	lIT	Y
kopdoek	lIr	d
kopenhagen	D4W	v
kopiereg	lJI	g
koppelaar	lJo	k
koppie	lKM	h
koppiesenpierings	lKt	BO
korinthies	D5F	l
kort	lL7	h
kos	lMc	s
kostelik	lNI	/
kou	lOH	T
koud	lO+	Z
koud	lOa	k
kous	lPX	Z
kraal	lPw	X
krag	lQH	n
krap	lQu	X
kredietkaart	lRF	s
kreef	lRx	o
kremlin	D5q	e
kreta	D6I	Z
kreëer	lSZ	c
krim	D6h	W
krisis	lS1	x
krisjna	D63	e
kristal	lTm	e
kritiseer	lUE	t
kroaat	D7V	d
kroasië	D7y	p
kroaties	D8b	m
krokodil	lUx	j
kronkel	lVU	z
kropslaai	lWH	i
kruier	lWp	b
kruip	lXE	e
kruis	lXi	X
kruisberg	D9B	s
kruisskyf	lX5	s
kruk	lYl	W
kry	lY7	i
kuba	D9t	U
kubaan	D+B	a
kubus	lZd	W
kudde	lZz	BG
kuier	la5	u
kuikendief	lbn	r
kultuur	lcS	c
kuns	lcu	T
kunsgalery	ldB	u
kunstenaar	ldv	n
kunstig	leW	BV
kurk	lfr	U
kursus	lf/	i
kus	lgh	u
kussing	lhP	d
kwaai	lhs	t
kwalifikasie	liZ	4
kwalifiseer	ljR	m
kwartier	lj3	r
kweek	lki	h
kwessie	llD	z
kwytskelding	ll2	t
kyker	lmj	e
laag	lnB	W
laai	lnX	p
laat	loA	9
laatste	lo9	c
laerskool	lpZ	r
lag	lqE	T
laken	lqX	a
lam	lqx	S
lamp	lrD	U
landbou	lrX	1
landbouer	lsM	t
landbouskool	ls5	5
landskap	lty	r
lang	lud	U
langs	lux	BQ
langsaan	lwB	g
lank	lwh	z
lap	D+b	d
lapland	D+4	e
laplander	D/W	r
laplands	EAB	m
later	lxU	BJ
latyn	EAn	a
latyns	EBB	c
lawaai	lyd	BC
leef	lzf	e
leek	lz9	W
leen	l0T	W
leer	l0p	s
leerware	l1V	p
lees	l1+	U
leeu	l2S	U
legende	l2m	e
lei	l3E	x
leiden	EBd	c
leiding	l31	2
leier	l4r	a
lek	l5F	S
lekker	l5X	Bp
lekkers	l7A	t
lektor	l7t	l
lelie	l8S	W
lelik	l8o	f
lemming	l9H	d
lemoen	l9k	Z
lengte	l99	b
lening	l+Y	a
lente	l+y	l
lepel	l/X	Z
les	l/w	U
lessenaar	mAE	4
let	EB5	b
letland	ECU	d
lets	ECx	g
lettergreep	mA8	p
letterkunde	mBl	s
leunstoel	mCR	i
lewe	mCz	W
lewendig	mDJ	+
lewer	mEH	4
leër	mE/	V
libanon	EDR	i
liberië	EDz	m
libies	EEZ	Y
libië	EEx	d
libiër	EFO	e
lid	mFU	z
lidmaatskap	mGH	t
lief	mIf	e
liefde	mG0	i
liefhê	mHW	Z
lieflik	mHv	w
liewer	mI9	q
lig	mJn	T
liggaam	mJ6	b
ligroos	mKV	c
lindeboom	mKx	5
linguïs	mLq	i
linguïsties	mMM	r
linkerkant	mM3	w
links	mNn	2
lisensie	mOd	q
lissabon	EFs	j
litaue	EGP	f
litauer	EGu	h
litaus	EHP	f
liter	mPH	e
literatuur	mPl	n
logies	mQM	c
lok	mQo	i
londen	EHu	b
long	mRK	U
loop	mRe	4
loos	FZo	i
lork	mSW	V
lorkboom	mSr	f
lot	mTK	9
lotaringe	EIJ	1
lourier	mUH	e
lucifer	EI+	p
lug	mUl	R
lughawe	mU2	BF
lugpos	mV7	c
lugposbrief	mWX	2
lui	mXN	q
luik	EJn	W
luiperd	mX3	e
luister	mYV	d
luister	mYy	d
lupien	mZP	Y
lupine	mZn	a
lus	maB	t
lusern	EJ9	f
luukse	mau	6
lyf	mbo	U
lyfland	EKc	g
lyflands	EK8	j
lyk	mb8	BI
lyn	mdE	U
lys	mdY	U
lê	mds	a
ma	meG	U
maag	mea	Y
maak	mey	w
maal	mfi	f
maaltyd	mgB	e
maan	mgf	V
maand	mg0	Y
maandag	ELf	e
maar	mhM	1
maart	EL9	Y
macedonië	EMV	r
machiavelli	ENA	p
madagaskar	ENp	r
madonna	EOU	e
madrid	EOy	b
maer	miB	BI
mag	mjJ	B1
makker	mk+	y
maklik	mlw	z
maksimum	mmj	i
mal	mnF	m
mal	moS	e
malakka	EPN	i
maleis	EPv	b
malmokkie	mnr	n
malta	EQK	Y
maltees	EQi	e
malteser	ERA	i
man	mow	V
mandjie	mpF	c
mangaan	mph	h
mango	mqC	Z
manlik	mqb	p
mantsjoerye	ERi	u
marialigmis	ESQ	w
mariëteklokke	mrE	BI
mark	msM	2
marmotjie	mtC	p
marokkaan	ETA	k
marokkaans	ETk	m
marokko	EUK	d
marter	mtr	b
masboom	muG	p
masjien	muv	k
masker	mvT	Z
massa	mvs	BN
mat	mw5	U
materieel	mxN	k
matig	mxx	p
medies	mya	b
medisyne	my1	7
medium	mzw	t
meebring	m0d	w
meedeel	m1N	BL
meen	m2Y	BX
meer	m3v	6
meeste	m4p	Z
meganisme	m5C	o
mei	EUn	S
meisie	m5q	l
mekaar	m6P	t
mekka	EU5	X
melanesies	EVQ	t
melanesië	EV9	y
melanesiër	EWv	z
meld	m68	Bs
melk	m8o	U
meng	m88	r
mengsel	m9n	p
menigte	m+Q	BJ
mening	m/Z	d
mens	m/2	h
mensekind	nAX	v
menslik	nBG	d
merendeels	nBj	BV
merk	nC4	m
mes	nDe	T
met	nDx	1
meter	nEm	Z
meubel	nE/	o
mexikaans	EXi	m
mexiko	EYI	b
middag	nFn	i
middagete	nGJ	y
mielies	nG7	0
miljoen	nHv	c
millimeter	nIL	q
min	nI1	U
minder	nJJ	g
mineraal	nJp	i
minimum	nKL	f
minister	nKq	i
minste	nLM	i
minuut	nLu	Z
mis	nMH	X
miskien	nMe	BA
misterieus	nNe	2
mite	nOU	U
mode	nOo	g
modern	nPI	c
moed	nPk	V
moeder	nP5	Z
moedermaagd	EYj	o
moeg	nQS	T
moeilik	nQl	z
moeilikheid	nRY	1
moeite	nSN	a
moet	nSn	t
mohammedaans	EZL	p
mohammedanisme	EZ0	u
mol	nTU	S
mond	nTm	V
mongolië	Eai	o
monnik	nT7	Y
monster	nUT	1
montenegro	EbK	o
montenegryn	Eby	w
montenegryns	Eci	y
monument	nVI	h
mooi	nVp	x
moontlik	nWa	i
moontlikheid	nW8	x
moordenaar	nXt	q
moreel	nYX	Z
morfologie	nYw	3
mosambiek	EdU	m
moskowiet	Ed6	n
mossie	nZn	Z
mot	naA	S
motel	naS	a
motor	nas	Y
motorfiets	nbE	q
motorfietsryer	nbu	7
motorhawe	ncp	p
motoris	ndS	k
motreën	nd2	v
muis	nel	V
munt	ne6	U
muntstuk	nfO	d
mus	nfr	R
museum	nf8	b
musiek	ngX	Y
musiekinstrument	ngv	9
muur	nhs	S
muurbal	nh+	b
my	niZ	g
myl	ni5	U
myn	njN	U
mynbou	njh	e
myne	nj/	X
myself	nkW	d
môre	nkz	c
môreaand	nlP	w
môreoggend	nl/	z
n	1U8	Q
n	1VM	b
n	1Vn	b
n	1WC	T
n	1WV	Z
na	n/9	l
na	nmy	BQ
na	oAi	g
na	oBC	c
naaldwerk	noC	f
naam	noh	t
naamlik	npO	k
naand	npy	f
naaste	nqR	j
naasteliefde	nq0	BE
naburig	nr4	3
naby	nsv	BP
nadat	nt+	a
nadelig	nuY	BK
nader	nvi	q
naderkom	nwM	BR
nael	nxd	V
naelpolitoer	nxy	0
nag	nym	T
nagereg	ny5	j
nagklub	nzc	t
nagvlinder	n0J	i
nakomelingskap	n0r	3
nalatenskap	n1i	t
namekaar	n2P	s
namen	Eeh	a
namibië	Ee7	l
nar	n27	p
narkotiseur	n3k	x
nasien	n4V	b
nasionaal	n4w	l
nasionaliteit	n5V	x
nat	n6G	R
natuur	n6X	p
natuurlik	n7A	+
naverwantskap	n7+	Bi
navorsing	n9g	Ba
navraag	n+6	i
naweek	n/c	h
ndebele	Efg	g
nederduits	EgA	r
nederlander	Egr	s
nederlands	EhX	m
nee	oBe	Q
neef	oBu	j
neem	oCR	BO
nege	oDf	W
negentien	oD1	l
negentig	oEa	h
nek	oE7	S
net	oFN	BM
netnou	oGZ	a
neuk	oGz	r
neus	oHe	V
nguni	Eh9	a
nie	oHz	P
niemand	oIC	0
nier	oI2	W
nietemin	oJM	5
nig	oKF	T
nigeria	EiX	g
niggie	oKY	k
niks	oK8	o
niks	oLk	X
nodig	oL7	e
nodig	oMZ	i
noem	oM7	V
nog	oNQ	Y
nog	oPN	V
nog	oPi	h
nogal	oNo	Bl
nommer	oQD	j
noodhulp	oQm	j
nooi	oRJ	W
noor	Ei3	a
noordamerika	EjR	4
noordelik	oRf	l
noordpool	EkJ	v
noordpool	oSE	m
noordwaarts	oSq	9
noors	Ek4	c
noorweegs	ElU	l
noorweë	El5	f
noorweër	EmY	k
noot	oTn	u
normaal	oUV	e
notisie	oUz	n
nou	oV7	e
nou	oWZ	d
nounou	oVa	h
november	Em8	k
nuus	oW2	q
nuuskierig	oXg	0
nuut	oYU	Y
nuwejaarsdag	Eng	z
nuweling	oYs	f
nywerheid	oZL	p
nè	oZ0	s
nêrens	oag	f
o	oa/	O
o	qIj	P
oefen	obN	j
oefening	obw	q
oekraine	EoT	z
oekrainer	EpG	j
oekrains	Epp	g
oeros	oca	Y
of	ocy	O
offisieel	odA	j
oktober	EqJ	h
olie	odj	U
olifant	od3	j
olm	oea	T
om	oet	v
om	ojV	l
omdat	ofc	BE
omgewing	ogg	+
omsit	ohe	Z
omstandigheid	oh3	z
omtrent	oiq	r
onaangenaam	oj6	Bc
onafhanklik	olW	BJ
ondankbaar	omf	BB
onder	ong	z
onderaan	ooT	5
onderdruk	opM	BB
onderhoud	oqN	6
onderneming	orH	r
onderrig	ory	k
ondersoek	osW	B6
ondersteun	ouQ	0
ondertoe	ovE	u
ondervinding	ovy	s
onderwerp	owe	y
onderwys	oxQ	m
onderwyser	ox2	1
onderwyseres	oyr	BA
ongedierte	ozr	n
ongeduldig	o0S	o
ongeluk	o06	k
ongelukkig	o1e	5
ongenaakbaar	o2X	x
ongetroud	o3I	u
onjuis	o32	/
onlangs	o41	f
onnatuurlik	o5U	p
onnodig	o59	i
ons	o6f	o
ons	o72	T
onskuldig	o7H	v
ontbied	o8J	i
ontbreek	o8r	/
ontbyt	o9q	g
ontdek	o+K	l
ontdekking	o+v	l
ontevrede	o/U	BG
onthaal	pAa	d
onthou	pA3	x
ontklee	pBo	e
ontkom	pCG	h
ontlok	pCn	BV
ontmoet	pD8	2
ontploffing	pEy	o
ontslaan	pFa	4
ontsnap	pGS	j
ontspanning	pG1	1
ontvang	pHq	p
ontvangsdame	pIT	x
ontvoer	pJE	d
ontwikkel	pJh	q
ontwikkeling	pKL	4
onvatbaar	pLD	j
oog	pLm	S
oogmerk	pL4	y
ook	pMq	i
oom	pNM	U
oomblik	pNg	n
oomskind	pOH	g
oop	pOn	T
oopmaak	pO6	m
oor	pPg	Bf
oordeel	pQ/	s
oordra	pRr	BB
ooreenkoms	pSs	BK
ooreenstemming	pT2	BR
oorgenoeg	pVH	l
oorkant	pVs	g
oorlog	pWM	Z
oorlog	pWl	o
oorsend	pXN	m
oorsig	pXz	9
oorskadu	pYw	p
oorskry	pZZ	0
oorsprong	paN	i
oorspronklik	pav	BJ
oorsteek	pb4	5
oorstroom	pcx	i
oortollig	pdT	0
oortreding	peH	y
oortree	pe5	n
oorweeg	pfg	Bx
oorwinning	phR	l
oosduitsland	Eqq	6
oossee	Erk	f
ooste	ph2	e
oostelik	piU	s
oostenryk	EsD	o
oostenryker	Esr	u
oostenryks	EtZ	r
ooswaarts	pjA	2
op	p+Q	m
op	pj2	7
opdrag	pkx	3
openbaring	EuE	t
openlik	plo	g
opera	pmI	b
operasie	pmj	6
opereer	pnd	h
opgaan	pn+	BJ
ophang	ppH	b
ophef	ppi	k
ophou	pqG	BL
opinie	prR	c
opklaar	prt	f
oplaai	psM	k
oplei	psw	BB
opleiding	ptx	o
oplewer	puZ	w
oplossing	pvJ	l
opmerk	pvu	d
opmerking	pwL	BA
oppas	pxL	Bz
oppervlakte	py+	m
oppik	pzk	0
oproep	p0Y	m
opsegging	p0+	y
opsig	p1w	d
opsit	p2N	b
opskep	p2o	e
opstaan	p3G	BY
opstandig	p4e	1
optel	p5T	y
optree	p6F	n
optrek	p6s	p
opvatting	p7V	6
opvoering	p8P	q
opwen	p85	k
opwinding	p9d	z
oral	p+2	o
oranje	Ev1	e
oranje	p/e	p
oranjevrystaat	Eux	BE
organisasie	qAH	t
organiseer	qA0	m
orgidee	qBa	e
orkes	qB4	c
oseaan	qCU	e
oud	qCy	S
ouderdom	qDE	g
ouderwets	qDk	5
oudmodies	qEd	7
ouer	qFY	m
ouerloos	qF+	k
ouers	qGi	b
ouma	qG9	Y
oupa	qHV	a
outyds	qHv	0
pa	qIy	U
paasfees	EwT	g
pad	qJG	e
padda	qJk	h
pak	qKF	k
pak	qMQ	j
pakket	qKp	Y
pakkie	qLB	g
pakplek	qLh	v
paling	qMz	a
palladium	qNN	o
pampoen	qN1	r
pan	qOg	Bd
pap	qP9	Z
papaja	qQW	n
papegaai	qQ9	g
paradys	qRd	k
parasiet	qSB	i
parfuum	qSj	c
parkeer	qS/	b
parkeerplek	qTa	Be
pars	qU4	b
party	qVT	BZ
parys	Ewz	a
pas	qWs	B2
pase	ExN	Z
passasier	qYi	k
pater	qZG	Z
patroon	qZf	7
pawiljoen	qaa	i
peer	qa8	U
peking	Exm	l
pensioen	qbQ	r
pensioentrekker	qb7	BO
pensionaris	qdJ	BP
peper	qeY	a
per	qey	BX
per	qmv	Y
perd	qgJ	V
perdry	qge	l
permanent	qhD	CH
perron	qjK	p
pers	qjz	i
persent	qkV	q
persies	EyL	c
persiese	Eyn	k
persië	EzL	n
perske	qk/	a
persoon	qlZ	e
persoonlik	ql3	4
pet	qnH	R
petrol	qnY	v
piano	qoH	Z
piekniek	qo7	b
piekniek	qog	b
pienk	qpW	V
piesang	qpr	b
pietermaritzburg	Ezy	8
pikswart	qqG	k
pil	qqq	S
pireneë	E0u	i
pit	qq8	o
pla	qrk	V
plaas	qr5	Bf
plaaslik	qtY	f
plaat	qt3	l
plaatsvind	quc	3
plak	qvT	9
plan	qwQ	BY
plant	qxo	X
plantasie	qx/	m
plastiek	qyl	e
platduits	E1Q	l
plattelands	qzD	m
pleeg	qzp	x
pleegkind	q0a	p
pleegmoeder	q1D	t
pleegouers	q1w	v
pleegseun	q2f	o
pleegvader	q3H	v
plek	q32	q
plesier	q4g	k
plig	q5E	g
ploert	q5k	3
plus	q6b	U
poeding	q6v	c
poeier	q7L	r
poging	q72	x
pole	E11	Z
poliesman	q8n	k
polisie	q9L	a
polisiestasie	q9l	0
politiek	q+Z	h
polities	q+6	f
politikus	q/Z	n
polshorlosie	rAA	5
pomp	rA5	U
ponie	rBN	X
pool	E2O	V
pools	E2j	Z
poot	rBk	Z
pop	rB9	a
populier	rCX	h
populêr	rC4	j
porsie	rDb	Y
portugees	E28	/
pos	rDz	S
posgeld	rEF	e
posisie	rEj	c
poskaart	rE/	q
poskantoor	rFp	s
poswissel	rGV	m
pot	rG7	W
potblou	rHR	j
pous	rH0	V
pouse	rIJ	2
poësie	rI/	c
praat	rJb	e
pragtig	rJ5	1
prakties	rKu	g
predikant	rLO	y
prent	rMA	t
presies	rMt	j
presteer	rNQ	BA
pretensieus	rOQ	s
pretoria	E37	l
preuts	rO8	c
primitief	rPY	j
prinsipaal	rP7	l
privaat	rQg	h
privaat	rRB	e
probeer	rRf	o
probleem	rSH	o
produk	rSv	b
produksie	rTK	j
produseer	rTt	v
proe	rUc	T
professioneel	rUv	v
professor	rVe	j
profyt	rWB	r
program	rWs	f
projek	rXL	p
prokureur	rX0	q
promosie	rYe	i
proses	rZA	x
protes	rZx	b
protesteer	raM	n
provinsie	raz	h
provizore	rbU	o
prys	rb8	8
psigiater	rc4	q
puberteit	rdi	y
publiek	reU	b
puik	rev	b
puisie	rfK	Z
punt	rfj	o
puriteins	rgL	j
put	rgu	S
pyl	rhA	V
pyn	rhV	y
pynappel	riH	k
pyp	rir	U
raad	ri/	g
raadpleeg	rjf	j
raadskamer	rkC	q
raak	rks	7
raamwerk	rln	x
rabbi	rmY	W
radio	rmu	1
radium	rnj	f
rakkie	roC	X
ram	roZ	W
rapport	rov	BD
ras	rpy	Z
ratel	rqL	b
ratkas	rqm	s
reageer	rrS	l
rebel	rr3	i
rede	rsZ	BC
ree	rtb	R
reeds	rts	m
reg	ruS	BO
regeer	rvg	0
regering	rwU	1
reghoekig	rxJ	v
regime	rx4	d
register	ryV	4
registreer	rzN	u
regmaak	rz7	j
regop	r0e	q
regs	r1I	2
regterkant	r1+	x
regtig	r2v	1
reguit	r3k	z
regverdig	r4X	x
reis	r5I	z
rekenaar	r57	m
rekenbord	r6h	l
rekening	r7G	BD
rekenmeester	r8J	w
rekenraam	r85	BG
rektig	r9/	BA
rem	r+/	T
renoster	r/S	r
reptiel	r/9	c
republiek	sAZ	i
res	sA7	d
resep	sBY	n
respek	sB/	c
respekteer	sCb	l
retoerkaartjie	sDA	2
reuk	sD2	q
reus	sEg	W
rewolwer	sE2	i
reël	sFY	3
reëlmatig	sGP	8
reën	sHL	V
reënboog	sHg	i
rig	sIC	q
rigting	sIs	g
ring	sJM	U
ritus	sJg	W
rivier	sJ2	a
rob	sKQ	d
robot	sKt	a
robyn	sLH	Y
rodium	sLf	g
roeier	sL/	Z
roemeen	E4g	d
roemenië	E49	m
roemeniër	E5j	n
roer	sMY	BC
roete	sNa	W
rog	sNw	R
rok	sOB	T
rol	sOU	f
rolletjie	sOz	d
rolprent	sPQ	0
rome	E6K	X
romp	sQE	V
rond	sQZ	V
rood	sQu	U
roofdier	sRC	n
rooihond	sRp	n
rooihuid	E6h	w
rooikat	sSQ	b
rook	sSr	W
room	sTB	W
roos	sTX	V
rooster	sTs	BH
rot	sUz	R
rots	sVE	U
rou	sVY	g
rubriek	sV4	j
rug	sWb	S
rugryer	sWt	z
ruik	sXg	V
rukkie	sX1	h
rus	E7R	V
rus	sYW	a
rusie	sYw	X
rusie	sZH	g
rusland	E7m	d
russies	E8D	b
ry	sZn	j
rybewys	saK	v
ryk	sa5	z
ryp	sbs	c
rys	scI	U
saad	scc	V
saag	scx	U
saak	sdF	+
saal	seD	X
saam	sea	Z
saam	siO	p
saambring	sez	1
saamgaan	sfo	BN
saamstem	sg1	m
saamwerk	shb	z
saans	si3	h
sag	sjY	S
sak	sjq	U
sakeman	sj+	2
salamander	sk0	p
salaris	sld	t
salmander	smK	m
sambreel	smw	h
samelewing	snR	r
sand	sn8	U
sandaal	soQ	e
sanger	sou	b
sanksie	spJ	e
sap	spn	Y
sardien	sp/	c
sardinies	E8e	i
satan	E9A	j
sebra	sqb	Z
sedert	sq0	n
see	srb	R
seeanemoon	srs	v
seehond	ssb	m
seekoei	stB	p
seer	stq	X
seer	suB	m
seil	sun	V
seker	su8	s
seker	sxM	i
sekerheid	svo	BA
sekerlik	swo	k
sekondêr	sxu	/
sekretaresse	syt	u
seks	szb	T
sektor	szu	b
sekuriteitsbeampte	s0J	BH
selde	s1Q	Z
selebrasie	s1p	t
self	s2W	u
selfs	s3E	W
sendeling	s3a	m
sensitief	s4A	y
sent	s4y	U
sentimeter	s5G	r
sentraal	s5x	h
sentrale	s6S	z
september	E9j	l
sertifikaat	s7F	4
sertifiseer	s79	v
servette	s8s	f
serwies	E+I	Z
serwië	E+h	h
serwiër	E/C	f
ses	s9L	R
sesde	s9c	Y
sestien	s90	c
sestig	s+Q	a
seun	s+q	r
sewe	s/V	X
sewende	s/s	g
sewentien	tAM	m
sewentig	tAy	i
seën	tBU	W
siamees	E/h	g
siek	tBq	X
sielkundige	tCB	r
sien	tCs	v
sieraad	tDb	3
sigaar	tES	b
sigaret	tEt	h
sigbaar	tFO	f
sigeuner	tFt	n
silicium	tGU	h
silwer	tG1	b
simbool	tHQ	e
simfonie	tHu	h
simpatie	tIP	i
sin	tIx	W
sing	tJH	U
sinies	tJb	Z
sinneloos	tJ0	k
sint	FAB	c
sit	tKY	2
sitkamer	tLO	5
sitplek	tMH	b
situasie	tMi	BN
sjampoe	tNv	e
sjerrie	tON	a
sjimpansee	tOn	o
sjina	FAd	X
sjinees	FA0	d
sjokolade	tPP	o
skaak	tP3	Y
skaal	tQP	Y
skaam	tRE	d
skaamte	tQn	d
skaap	tRh	Y
skaapvleis	tR5	l
skaars	tSe	BD
skade	tTh	b
skadu	tT8	m
skakel	tUi	r
skakering	tVN	1
skandaal	tWC	s
skare	tWu	B8
skat	tYq	m
skeef	tZQ	j
skeer	tZz	X
skema	taK	q
skemer	ta0	a
skep	tbO	W
skerm	tbk	a
skerp	tb+	X
skets	tcV	p
ski	tc+	Q
skielik	tdO	u
skiereiland	td8	s
skil	teo	n
skilderagtig	tfP	w
skildery	tf/	t
skilpad	tgs	f
skip	thL	c
skitterend	thn	u
skoen	tiV	U
skok	tip	l
skone	tjO	s
skool	tj6	BI
skoolvakansie	tlC	1
skoon	tl3	Y
skoonbroer	tmP	w
skoondogter	tm/	0
skoonma	tnz	r
skoonmaak	toe	+
skoonmoeder	tpc	w
skoonouers	tqM	y
skoonseun	tq+	r
skop	trp	U
skot	FBR	e
skotland	FBv	h
skots	FCQ	a
skottelgoed	tr9	3
skouer	ts0	e
skraal	ttS	BS
skreeu	tuk	q
skrif	tvO	h
skriftelik	tvv	l
skryf	twU	Z
skrywer	twt	n
skuim	txU	d
skuld	txx	g
skuldig	tyR	d
skyf	tyu	w
skyn	tze	s
skêr	t0K	b
slaaf	t0l	Y
slaag	t09	a
slaai	t1X	X
slaap	t1u	j
slaapkamer	t2R	o
slag	t25	t
slagoffer	t3m	h
slagter	t4H	e
slams	FCq	l
slang	t4l	g
slavin	t5F	z
slee	t54	e
sleep	t6W	b
sleg	t6x	3
slegs	t7o	p
sleutel	t8R	j
slim	t80	r
sloot	t9f	j
slovenië	FDP	t
slowaak	FD8	d
slowaaks	FEZ	f
slowakies	FE4	m
slowakye	FFe	p
sloween	FGH	o
sloweens	FGv	h
sluit	t+C	i
sluk	t+k	X
smaak	t+7	Y
smaaklik	t/T	l
smeek	t/4	Z
smôrens	uAR	o
snags	uA5	2
snawel	uBv	h
sneeu	uCQ	W
sneeuwit	uCm	j
snelheid	uDJ	f
snelheidsgrens	uDo	BE
sny	uEs	s
so	uFY	3
so	uU/	i
so	uV9	o
so	uVh	c
soedan	FHQ	Y
soek	uGP	c
soen	uGr	S
soet	uG9	p
sofa	uHm	X
sog	uH9	R
sokker	uIO	k
sokkie	uIy	W
solank	uJI	BA
soldaat	uKI	l
somer	uKt	b
sommer	uLI	r
sommige	uLz	n
somtyds	uMa	x
son	uNL	b
sondag	FHo	b
sonde	uNm	l
sonder	uOL	b
sonnig	uOm	z
soogdier	uPZ	g
soort	uP5	d
sorg	uQW	r
sorgvuldig	uRB	t
sosiaal	uRu	e
sous	uSM	d
sout	uSp	V
sowaar	uS+	BY
sowat	uUW	p
spaans	FID	z
spaanse	FI2	x
spaar	uWl	e
spandeer	uXD	+
spanje	FJn	a
spanning	uYB	o
speel	uYp	W
sperma	uY/	a
spesiaal	uZZ	u
spesifiek	uaH	i
spierwit	uap	j
spiraal	ubM	d
spoed	ubp	l
spoel	ucO	3
spog	udF	b
spook	udg	h
sport	ueB	X
sportgrond	ueY	s
spring	ufE	m
sprinkaan	ufq	w
sprong	uga	e
spuug	ug4	U
spyskaart	uhM	i
staal	uhu	Y
staan	uiG	BS
staat	ujY	v
stad	ukH	a
stadigaan	ukh	8
staf	uld	V
staking	uly	f
stalhings	umR	j
stam	um0	1
stamboom	unp	k
standaard	uoN	q
standbeeld	uo3	j
standpunt	upa	k
stap	up+	b
stapel	uqZ	BT
stapper	urs	e
stasie	usK	c
steeds	usm	g
steel	utG	X
steenbok	FKB	i
steenkool	utd	h
stelling	ut+	l
stelsel	uuj	d
stem	uvA	V
ster	uvV	k
sterf	uv5	BN
sterk	uxG	Y
stert	uxe	W
stewig	ux0	2
stiefbroer	uyq	p
stiefdogter	uzT	t
stiefkind	u0A	l
stiefmoeder	u0l	p
stiefsuster	u1O	r
stiefvader	u15	r
stilhou	u2k	y
stilswygend	u3W	q
stoel	u4A	V
stoep	u4V	e
stok	u4z	i
stop	u5V	a
storie	u5v	0
stort	u6j	Y
straat	u67	b
straf	u7W	c
strak	u7y	a
strand	u8M	Z
strandwolf	u8l	j
strategies	u9I	m
streek	u9u	a
strek	u+I	V
stroom	u+d	Z
struik	u+2	f
struktuur	u/V	i
studeer	u/3	b
student	vAS	n
studie	vA5	X
stuk	vBQ	BI
stukkend	vCY	6
stuur	vDS	g
styg	vDy	Bj
styl	vFV	X
subsidie	vFs	e
suggestie	vGK	BB
suidafrika	FKj	0
suidafrikaans	FLX	4
suidafrikaner	FMP	6
suidamerika	FNJ	1
suide	vHL	Y
suidelik	vHj	p
suidelike	FN+	s
suidpool	FOq	m
suidwaarts	vIM	6
suiker	vJG	a
suikerriet	vJg	p
suip	vKJ	m
suiwer	vKv	Z
sukses	vLI	p
sultan	vLx	b
supermark	vMM	o
surplus	vM0	e
suster	vNS	n
susterskind	vN5	0
suurlemoen	vOt	h
suurlemoensap	vPO	u
swaai	vP8	6
swaan	vQ2	X
swaar	vRN	t
swaer	vR6	l
swak	vSf	i
swanger	vTB	w
swart	FPQ	n
swart	vTx	X
swarte	vUI	a
swede	FP3	a
sweed	FQR	X
sweeds	FQo	b
sweer	vUi	X
swem	vU5	b
swembad	vVU	9
swerf	vWR	1
swerm	vXG	Z
swerwer	vXf	e
switser	FRD	c
switserland	FRf	8
swyn	vX9	h
sy	vYe	u
sy	vaV	W
syfer	vZM	z
syne	vZ/	W
sê	var	X
taak	vbC	o
taal	vbq	h
taamlik	vcL	CA
tabak	veL	a
tafel	vel	a
tafeldoek	ve/	r
tafelskuimer	vfq	BA
tagtig	vgq	b
tak	vhF	b
takbok	vhg	Z
taksisboom	vh5	r
tamatie	vik	e
tandarts	vjC	g
tandpyn	vji	i
tans	vkE	f
tant	vkj	U
taxi	vk3	V
taxibestuurder	vlM	BD
taxidrywer	vmP	8
te	vnL	Z
te	wCO	a
teater	vnk	e
tee	voC	R
teel	voT	o
teen	vo7	Bi
teengif	vqd	f
teenoorgesteld	vq8	Bm
teenstelling	vsi	BU
teenwoordigheid	vt2	0
teer	vuq	v
tegelyk	vvZ	BZ
tegnies	vwy	e
tegnologie	vxQ	n
teken	vx3	9
teks	vy0	b
tel	vzP	T
telefoon	vzi	k
telegrafeer	v0G	q
telegram	v0w	i
televisie	v1S	o
televisiestel	v16	7
telraam	v21	+
tempel	v3z	b
temperatuur	v4O	q
ten	v6f	x
ten	v7Q	W
ten	v7m	BU
ten	v86	BD
tenk	v44	e
tennis	v5W	a
tensy	v5w	b
tent	v6L	U
term	v99	W
tert	v+T	Z
terug	v+s	V
terugbesorg	v/B	y
terugkom	v/z	r
terwyl	wAe	6
tevrede	wBY	2
themp	FSb	k
tien	wCo	R
tier	wC5	j
tikster	wDc	d
tipe	wD5	U
tipies	wEN	u
tjek	wE7	e
tjekboek	wFZ	l
toe	wF+	BW
toegang	wHU	l
toeganklik	wH5	n
toekoms	wIg	b
toemaak	wI7	h
toepas	wJc	i
toeristeburo	wJ+	z
toernooi	wKx	h
toeskouer	wLS	k
toespreek	wL2	o
toestand	wMe	BG
toestel	wNk	r
toeter	wOP	Z
toetree	wOo	Z
toets	wPB	U
toevlugsoord	wPV	BI
toevoeg	wQd	W
tog	wQz	v
toilet	wRi	c
toneel	wR+	Z
toneelspel	wSX	j
tongvis	wS6	b
toon	wTV	8
toonbank	wUR	i
top	wUz	a
toring	wVN	k
tot	wVx	Z
tot	wXM	Z
tot	wXl	j
totaal	wWK	j
totdat	wWt	f
tou	wYI	q
towenaar	wYy	BN
tower	wZ/	d
traan	wac	X
tradisie	waz	g
tradisioneel	wbT	v
tragedie	wcC	g
transkei	FTe	i
transparant	wci	r
transvaal	FUA	0
transvaals	FU0	q
trap	wdN	h
trawant	wdu	g
tref	weO	u
trein	we8	Y
trek	wfU	r
trommel	wf/	a
troos	wgZ	1
trop	whO	BE
tropies	wiS	f
trots	wix	X
trottoir	wjI	z
trou	wj7	v
tsjeg	FVe	7
tsjeggies	FWZ	BB
tsjeggoslowakye	FXa	BD
tuin	wkq	W
tuinmaak	wlA	j
tuis	wlj	X
tulp	wl6	V
turk	FYd	U
turks	FYx	Z
turkye	FZK	e
tussen	wmP	i
tv	FS/	f
twaalf	wmx	b
twak	wnM	X
twee	wnj	T
tweede	wn2	b
tweekeer	woR	e
tweeling	wov	d
twintig	wpM	d
twyfel	wpp	c
tyd	wqF	b
tydelik	wqg	BW
tydens	wr2	6
tydperk	wsw	o
tydskrift	wtY	9
u	wuV	r
u	xI6	O
ui	wvA	R
uit	wvR	a
uitbeeld	wvr	s
uitdaging	wwX	m
uitdeel	ww9	p
uitdruk	wxm	e
uitdrukking	wyE	p
uiteindelik	wyt	+
uitgaan	wzr	m
uitgawe	w0R	j
uitgee	w00	j
uitgeput	w1X	u
uitgesluit	w2F	p
uitgestrek	w2u	/
uitgewer	w3t	k
uithaal	w4R	B5
uithou	w6K	BL
uitleen	w7V	m
uitnodiging	w77	v
uitnooi	w8q	f
uitpak	w9J	d
uitroei	w9m	t
uitrusting	w+T	BG
uitsig	w/Z	b
uitslag	w/0	z
uitsluit	xAn	i
uitsonderlik	xBJ	t
uitspraak	xB2	r
uitstalling	xCh	3
uitstappie	xDY	BA
uitstekend	xEY	u
uitvind	xFG	f
uitvoer	xFl	f
uniek	xGE	W
uniform	xGa	h
universiteit	xG7	s
uraan	xHn	a
uself	xIB	a
uur	xIb	f
vaal	FbA	V
vader	xJI	b
vak	xJj	BO
vakant	xKx	b
val	xLM	Y
valk	xLk	W
vals	xL6	V
vampier	xMP	e
van	xMt	3
van	xQQ	a
van	xQq	X
vanaand	xNk	k
vanaf	xOI	e
vandag	xOm	a
vang	xPA	n
vanmiddag	xPn	p
variasie	xRB	h
vark	xRi	f
varkie	xSB	Z
vars	xS3	b
vars	xSa	d
vas	xTS	BO
vashou	xUg	l
vasmaak	xVF	BQ
vasstel	xWV	BO
vasteland	xXj	x
vat	xYU	BY
vatikaan	FbV	u
vee	xZs	X
veelvraat	xaD	l
veertien	xao	f
veertig	xbH	c
veg	xbj	d
veilig	xcA	i
veiligheid	xci	x
vel	xdT	S
veld	xdl	h
veldspaat	xeG	t
veldsprinkaan	xez	7
veldtog	xfu	f
venezolaan	FcD	t
venezolaans	Fcw	v
venezuela	Fdf	r
venster	xgN	w
venus	FeK	s
ver	xg9	BL
veral	xiI	BL
verander	xjT	y
verantwoordelik	xkF	BD
verbaas	xlI	d
verbaas	xll	x
verband	xmW	8
verbeeld	xn9	n
verbeelding	xnS	r
verbind	xok	y
verbinding	xpW	o
verbleik	xp+	e
verblyf	xqc	d
verborge	xq5	h
verbrand	xra	u
verbrands	xsI	f
verbruiker	xsn	m
verby	xtN	5
verbygaan	xuG	7
verbyganger	xvB	u
verbykom	xvv	p
verbysteek	xwY	4
verbysterd	xxQ	3
verdedig	xyH	h
verdien	xyo	BH
verdieping	xzv	w
verduidelik	x0f	BD
verduideliking	x1i	8
verdwaal	x2e	o
verdwyn	x3G	i
vereis	x3o	w
vereiste	x4Y	k
vereniging	x48	BH
vergadering	x6D	BG
vergeef	x7J	m
vergeet	x7v	d
vergelding	x8M	y
vergelyk	x8+	j
vergelyking	x9h	t
vergifnis	x+O	u
verhaal	x+8	Be
verhole	yAa	g
verhouding	yA6	v
verhuis	yBp	b
verjaarsdag	yCE	p
verkeer	yCt	BH
verkeerd	yD0	BH
verkeersknoop	yE7	Bl
verkeersreëls	yGg	y
verkies	yHS	s
verklaar	yH+	2
verklaring	yI0	5
verkoop	yJt	u
verkoopsman	yKb	p
verlaat	yLE	9
verlaging	yMB	w
verlang	yMx	/
verlang	yNw	f
verlede	yOP	o
verlies	yO3	Z
verlof	yPQ	q
verloofde	yP6	s
verloor	yQm	c
verlos	yRC	c
verlossing	yRe	5
verlëe	ySX	h
vermaak	yS4	6
vermeld	yTy	e
verminder	yUQ	BX
vermink	yVn	l
vermoë	yWM	BG
vermy	yXS	h
verneder	yXz	g
veronderstel	yYT	BW
veroorsaak	yZp	9
verorber	yam	2
verplaas	ybc	o
verpleeg	ycE	v
verpleegster	ycz	n
verplig	yda	k
verpligting	yd+	w
verraad	yeu	r
verrassing	yfZ	l
verruklik	yf+	u
vers	ygs	X
versamel	yhD	0
versameling	yh3	v
verseker	yim	2
versekering	yjc	r
versie	ykH	c
versigtig	ykj	t
verskeie	ylQ	i
verskil	yly	8
verskillend	ymu	o
verskole	ynW	i
verskoon	yn4	j
verskriklik	yob	n
verskyn	ypC	w
verslaan	ypy	q
verslag	yqc	u
verslank	yrK	e
versoek	yro	c
versoeking	ysE	m
versoendag	Fe2	BA
verstaan	ysq	t
verstel	ytX	o
vertaal	yt/	h
vertaling	yug	p
verteenwoordiger	yvJ	BC
vertel	ywL	q
vertolk	yw1	g
vertolking	yxV	s
vertoning	yyB	q
vertoon	yyr	x
vertraging	yzc	y
vertrek	y0O	Bd
vertroue	y1r	z
vertroue	y2e	s
vertrouwe	y3K	Bo
vervaardig	y4y	Bb
vervang	y6N	BC
vervelig	y7P	4
vervoer	y8H	g
verwag	y8n	5
verwant	y9g	8
verwantskap	y+c	BZ
verwantskapsbetrekking	y/1	Bz
verwar	zBo	+
verward	zCm	u
verwerf	zDU	8
verwysing	zEQ	n
veselperske	zE3	p
vet	zFg	t
vetterig	zGN	r
vier	zG4	U
vierde	zHM	b
viering	zHn	i
vietnamees	Ff2	o
vinger	zIJ	b
vinnig	zIk	BM
viool	zJw	Z
viooltjie	zKJ	f
vir	zKo	Co
virus	zNQ	X
vis	zNn	S
visie	zN5	X
visser	zOQ	d
visvang	zOt	b
vitamien	zPI	e
vitamine	zPm	g
vla	zQG	V
vlaams	Fge	d
vlaandere	Fg7	l
vlag	zQb	c
vlam	zQ3	V
vlaming	Fhg	h
vlei	zRM	l
vleis	zRx	X
vleisbraai	zSI	m
vleuel	zSu	a
vlieg	zTI	i
vliegtuig	zTq	BC
vliegveld	zUs	2
vlierboom	zVi	h
vlissingen	FiB	l
vloei	zWD	V
vloeistof	zWY	g
vlug	zW4	e
voedsel	zXW	m
voegwoord	zX8	l
voel	zYh	Z
voertuig	zY6	g
voetslaner	zZa	m
vol	zaA	0
vol	zfF	k
volg	za0	W
volgende	zbK	p
volgens	zbz	5
volledig	zcs	w
volstruis	zdc	i
volume	zd+	b
volwasse	zeZ	s
voor	zfp	k
voor	zvT	k
voorbeeld	zgN	j
voorberei	zgw	n
voordeel	zhX	s
voorgereg	ziD	m
voorgrond	zip	BB
voorheen	zjq	1
voorkom	zkf	BI
voorkop	zln	g
voorletter	zmH	l
voormalige	zms	BL
voornaam	zn3	6
voorraad	zox	g
voorreg	zpR	g
voorsit	zpx	d
voorsitter	zqO	x
voorskrif	zq/	m
voorspelling	zrl	BE
voorstad	zsp	g
voort	ztJ	m
voorval	ztv	/
voorwoord	zuu	l
vorentoe	zv3	v
vorm	zwm	p
voël	zxP	X
vra	zxm	0
vraag	zya	b
vragmotor	zy1	q
vrede	zzf	Z
vreedsaam	zz4	2
vreemd	z0u	r
vrees	z1Z	W
vreeslik	z1v	g
vreugde	z2P	l
vriend	z20	Y
vriendelik	z3M	BD
vriendelikheid	z4P	v
vriendin	z4+	d
vries	z5b	W
vrieshok	z5x	e
vroeg	z6P	V
vroegtydig	z6k	j
vroeër	z7H	x
vroeëre	z74	BC
vrolik	z86	r
vrou	z9l	h
vrouedag	Fim	m
vroulik	z+G	o
vrug	z+u	V
vrugbaar	z/D	h
vrugteloos	z/k	BF
vrydag	FjM	d
vryf	0Ap	V
vryheer	0A+	e
vryheid	0Bc	h
vrymaak	0B9	h
vrystaat	Fjp	t
vrywilliger	0Ce	r
vsa	FaK	2
vuil	0DJ	1
vuis	0D+	U
vulkaan	0ES	f
vurk	0Ex	U
vuur	0FF	S
vuurhoutjie	0FX	j
vyand	0F6	l
vyandelik	0Gf	v
vyf	0HO	U
vyfde	0Hi	a
vyftien	0H8	e
vyftig	0Ia	c
waag	0I2	j
waai	0JZ	U
waar	0Jt	h
waar	0T6	t
waarborg	0KO	s
waarde	0K6	i
waardeer	0Lc	t
waardevol	0MJ	v
waarheen	0M4	2
waarheid	0Nu	u
waarin	0Oc	s
waarmee	0PI	f
waarnatoe	0Pn	5
waarom	0Qg	u
waarsku	0RO	k
waarskuwing	0Ry	n
waarskynlik	0SZ	r
waarvandaan	0TE	2
waatlemoen	0Un	s
wag	0VT	y
wag	0W9	y
wagkamer	0WF	4
waleland	FkW	n
walhalla	Fk9	h
wallies	Fle	Z
wallis	Fl3	Z
walliser	FmQ	g
walvis	0Xv	a
wandel	0YJ	q
wandelaar	0Yz	n
wandelpad	0Za	i
wang	0Z8	V
want	0aR	n
ware	0a4	f
warm	0bX	W
was	0bt	R
wat	0b+	k
water	0ci	a
watter	0c8	Z
wedstryd	0dV	BB
weduwee	0eW	f
week	0e1	k
weekliks	0fZ	f
weeldeartikel	0f4	t
weens	0gl	BV
weens	Fmw	i
weer	0h6	BO
weeskind	0jI	f
weet	0jn	e
weggesteek	0kF	l
weghardloop	0kq	q
wegsteek	0lU	z
wegstuur	0mH	r
weier	0my	i
weiering	0nU	i
wekker	0n2	l
welke	0ob	Y
welkom	0oz	c
welvaart	0pP	BA
wen	0qP	d
wenk	0qs	a
wenkbrou	0rG	o
werk	0ru	2
werker	0sk	BV
werkersklas	0t5	BA
werkgewer	0u5	l
werklik	0ve	BN
werklikheid	0wr	s
werkloos	0xX	k
werkloosheid	0x7	y
werknemer	0yt	l
werktuigkundige	0zS	0
werkwoord	00G	g
wesel	00m	a
westelik	01A	h
westers	FnS	e
wet	01h	R
wetenskap	01y	m
wewenaar	02Y	l
whisky	029	q
wie	03n	P
wie	04J	o
wiel	032	T
wil	04x	/
wilde	06d	c
wildebees	05w	t
wilgerboom	065	n
wind	07g	U
winkel	070	r
winkelvenster	08f	0
wins	09T	c
winter	09v	b
wiskunde	0+K	l
wiskundig	0+v	o
wissel	0/X	4
wit	1AP	T
witmens	1Ai	r
woekerplant	1BN	o
woensdag	Fnw	g
woestynbewoner	1B1	z
wol	1Co	S
wolf	1C6	U
wolga	FoQ	a
wolvin	1DO	f
wond	1Dt	d
wonder	1EK	1
wonderbaarlik	1E/	BZ
woning	1GY	BA
woon	1HY	c
woonstel	1H0	p
woord	1Id	X
woordeboek	1I0	1
word	1Jp	6
wors	1Kj	Z
wortel	1K8	m
wreedaardig	1Li	m
wurm	1MI	W
wyn	1Me	U
wys	1My	By
wyse	1Ok	k
wysheid	1PI	g
wysie	1Po	f
wêreld	1QH	d
xeres	1Qk	a
xhosa	Foq	c
xhosa	FpG	Z
xhosavrou	Fpf	r
xilofoon	1Q+	l
yoghurt	1Rj	t
ys	1SQ	b
ysland	FqK	e
yslander	Fqo	l
yslands	FrN	i
yssee	Frv	g
yster	1Sr	Z
ytterbium	1TE	o
zambia	FsP	b
zeus	Fsq	V
zimbabwe	Fs/	k
zirkonium	1Ts	m
zoeloe	Ftj	k
