00databasealphabet	ECF	2
00databasedictfmt1121	B	b
00databaseinfo	c	ah
00databaseshort	a9	t
00databaseurl	bq	V
00databaseutf8	A	B
a	m8	O
aby	nK	k
adresa	nu	a
ale	oI	Q
američan	b/	w
anebo	oY	T
angina	or	j
anglický	pO	k
angličan	cv	x
ani ani	py	j
ano	qV	R
armáda	qm	V
asi	q7	1
aspoň	rw	X
auto	sH	U
autobus	sb	o
autor	tD	n
avšak	tq	y
ačkoliv	uc	o
až	vE	e
babička	vi	d
balík	v/	k
barva	wj	e
bedna	xB	U
bez	xV	W
bledý	xr	c
bluza	yH	Z
blízko	yg	/
bohatý	zf	5
bolení	0Y	g
bolest	04	g
boleti	1Y	o
bomba	2A	W
borůvka	2W	d
bota	2z	Y
bouda	3L	h
bouře	3s	Y
bouřka	4E	b
brambor	4f	d
bratr	48	a
bratranec	5W	d
brouček	5z	f
brzo	6S	Z
brzy	6r	V
bráti	7A	v
brýle	7v	n
buditi	8W	w
budova	9G	c
bulharsko	dg	h
bydleti	9i	f
bydliti	+B	g
báseň	+2	X
básník	/N	b
bílý	/o	d
bíti	BAF	l
běžeti	BAq	Y
březen	BBC	b
břicho	BBd	r
bůh	+h	V
bůh	eB	T
cena	BCI	X
cesta	BCf	h
cestička	BDA	a
chalupa	BDa	q
chladný	BEE	Z
chlapec	BEd	m
chléb	BFD	f
chutný	BFi	f
chytrý	BGB	w
chřipka	BGx	q
cibule	BHb	a
cizina	BH1	i
cukr	BIX	X
cíl	BIu	s
dcera	BJa	a
dcerka	BJ0	b
dceruška	BKP	f
den	BKu	a
deset	BLI	S
devět	BLa	W
deštník	BLw	e
dilemma	BMO	j
divadlo	BMx	d
dlouhý	BNO	a
dnes	BNo	Z
dneska	BOB	W
dobrý	BOX	j
doma	BO6	Y
donésti	BPS	f
dopis	BPx	b
dopoledne	BQM	c
doproviditi	BQo	m
dost	BRO	8
dostati	BSK	k
dosti	BSu	2
doufati	BTk	X
duben	BT7	Z
dva	BUU	S
dveře	BUm	U
dvě	BU6	V
dáti	BVj	V
dávati	BV4	Y
dýmka	BWQ	Z
děd	BWp	d
dělník	BXG	BS
děvče	BYY	p
dřevo	BZB	h
dům	BVP	U
elektrika	BZi	m
filosofie	BaI	l
fotografie	Bat	o
francie	eU	d
fysika	BbV	i
garáž	Bb3	a
halenka	BcR	d
harmonika	Bcu	h
herec	BdP	c
hlad	Bdr	X
hladový	BeC	Z
hlava	Beb	f
hluchý	Be6	X
hnědý	BfR	a
hoch	Bfr	j
hodina	BgO	j
hodiny	Bgx	g
hoditi	BhR	Z
hodný	Bhq	k
holandsky	BiO	c
hora	Biq	c
hrdina	BjG	V
hrdlo	Bjb	b
hruška	Bj2	Z
hudba	BkP	b
husa	Bkq	V
hvězda	Bk/	W
hymna	BlV	f
házeti	Bl0	Y
hřeben	BmM	a
inkoust	Bmm	Z
inzerát	Bm/	p
istivý	Bno	s
jablko	BoU	a
jabloň	Bou	i
jahoda	BpQ	e
jaksi	Bpu	h
jazyk	BqP	m
jeden	Bq1	U
jehně	BrJ	W
jeho	Brf	U
jejich	Brz	W
její	BsJ	U
játra	Bsd	Y
kasárna	Bs1	e
kniha	BtT	Z
knihovna	Bts	d
kolega	BuJ	f
komár	Buo	Y
kost	BvA	W
kvalita	BvW	j
květen	Bv5	Y
květina	BwR	j
labe	ex	T
labuť	Bw0	Z
led	BxN	S
leden	Bxf	W
les	Bx1	c
letadlo	ByR	r
letiště	By8	e
lev	Bza	Z
libra	Bzz	U
list	B0H	b
listopad	B0i	b
literatura	B09	j
londýn	fE	c
londýňan	fg	k
loď	B1g	j
loďka	B2D	U
ložnice	B2X	b
lupič	B2y	d
láhev	B3P	a
láska	B3p	j
lék	B4M	w
lékař	B48	k
lékárna	B5g	x
léto	B6R	d
líný	B6u	X
lžíce	B7F	b
malina	B7g	h
maminka	B8B	a
manžel	B8b	d
manželka	B84	b
maso	B9T	Y
matka	B9r	W
maďarsky	B+B	e
medvěd	B+f	b
meruňka	B+6	d
mezinárodní	B/X	p
mléko	CAA	j
modrý	CAj	Y
morava	gE	a
most	CA7	Y
motorka	CBT	c
moucha	CBv	h
moře	CCQ	V
mrkev	CCl	Y
muž	CC9	d
my	CDa	T
myš	CDt	S
máslo	CEU	Y
míč	CEs	X
mýdlo	CFD	Y
město	CFb	e
měsíc	CF5	a
můj	CD/	V
nebo	CGT	X
neděle	CGq	Y
nepřítomný	CHC	h
než	CHj	j
nikdo	CIG	v
noc	CI1	V
noha	CJK	X
norsko	ge	Z
nos	CJh	S
nosič	CJz	W
nový	CKJ	d
nádraží	CLZ	g
námořník	CL5	k
nápad	CMd	g
národ	CM9	a
národní	CNX	f
nízko	CN2	c
něco	COS	n
němec	g3	a
německo	hR	f
německy	CO5	b
nůž	CKm	X
nůžky	CK9	c
oblíbený	CPU	h
obraz	CP1	o
obvyklý	CQd	BA
obyčejně	CRd	t
odpoledne	CSK	n
odra	hw	T
okno	CSx	c
oko	CTN	R
olej	CTe	R
omáčka	CTv	g
on	CUP	a
ona	CUp	U
ono	CU9	P
opět	CVM	w
osm	CV8	U
osoba	CWQ	V
otec	CWl	W
otevřený	CW7	a
otázka	CXV	k
ovce	CX5	Y
oves	CYR	U
ovčák	CYl	a
papír	CY/	b
parno	CZa	X
pasažér	CZx	e
patro	CaP	b
paříž	iD	e
pekař	Caq	X
pekárna	CbB	c
peníze	Cbd	c
pes	Cb5	W
pianista	CcP	Z
pivo	Cco	c
plyn	CdE	S
po	CdW	a
pod	Cdw	t
podlaha	Ced	W
podzim	Cez	a
pohodlný	CfN	i
pokoj	Cfv	n
pole	CgW	V
polsko	ih	Z
polsky	Cgr	X
polák	i6	Y
polévka	ChC	Z
pondělí	Chb	f
poschodí	Ch6	u
postel	Cio	a
počasí	CjC	c
praha	jS	X
prapor	Cje	j
prase	CkB	h
profesor	Cki	d
prosinec	Ck/	f
proti	Cle	BS
prst	Cmw	W
prsten	CnG	X
prázdný	Cnd	j
párek	CoA	f
pátek	Cof	a
písek	Co5	Y
píseň	CpR	Z
pět	Cpq	X
přes	CqB	w
přijmouti	Cqx	2
přátelství	Crn	s
přítel	CsT	n
přítelkyně	Cs6	m
rada	Ctg	t
rakousko	jp	f
restaurace	CuN	f
rodina	Cus	h
rodiče	CvN	c
ruka	Cvp	Y
rus	kI	U
rusko	kc	X
rusky	CwB	X
ryba	CwY	U
rybář	Cws	b
rytmus	CxH	c
rána	Cx6	g
ráno	Cya	Z
růže	Cxj	X
sbohem	Cyz	w
schopný	Czj	i
sedm	C0F	Y
serum	C0d	V
sestra	C0y	Y
sestřenice	C1K	e
sever	C1o	q
sklep	C2S	h
skála	C2z	W
sladký	C3J	w
slepice	C35	j
slovo	C4c	Y
slovák	kz	c
sluha	C40	d
slunce	C5R	V
snacha	C5m	n
snad	C6N	7
snídaně	C7I	d
soudce	C7l	d
souhlasiti	C8C	v
soused	C8x	j
spaní	C9U	Z
spolu	C9t	c
srb	lP	T
srdce	C+J	W
starý	C+f	b
stroj	C+6	i
strom	C/c	V
strážník	C/x	g
strýc	DAR	g
studený	DAx	q
stěna	DB1	X
střecha	DCM	Y
středa	DCk	h
stříbrný	DDF	i
stůl	DBb	a
sud	DDn	i
svédsko	li	e
svět	DEJ	U
světlo	DEd	Y
sympatie	DE1	e
syn	DFT	X
sám	DFq	p
sýr	DGT	W
také	DGp	k
tele	DHN	V
teplo	DHi	W
teta	DH4	U
teď	DIM	d
thema	DIp	k
theorie	DJN	Z
tma	DJm	i
tmavý	DKI	Z
tupý	DKh	r
turecký	DLM	c
tužka	DLo	d
tvář	DMF	X
týden	DMc	Z
tělo	DM1	X
tři	DNM	U
třída	DNg	a
ucho	DN6	Z
uhlí	DOT	T
ulice	DOm	Y
umění	DO+	X
učitel	DPV	r
už	DQA	l
vagon	DQl	3
vajíčko	DRc	Z
varšava	mA	g
vchod	DR1	n
vdova	DSc	V
vdovec	DSx	Z
vejce	DTK	W
venkov	DTg	h
ves	DUB	Y
vesnice	DUZ	Y
večer	DUx	d
vlas	DVO	W
vlaštovka	DVk	c
voda	DWA	d
voják	DWd	e
vstup	DW7	j
vychytralý	DXe	s
vzduch	DYK	d
válka	DYn	V
váza	DY8	f
vídeň	mg	c
víno	DZb	W
vítr	DZx	W
výběr	DaH	m
východ	Dat	i
výška	DbP	l
včela	Db0	b
včera	DcP	d
věc	Dcs	X
věk	DdD	T
větev	DdW	e
věž	Dd0	f
všechno	DeT	v
všude	DfC	p
vždy	Dfr	f
vždycky	DgK	g
xylofon	Dgq	g
z	DhK	b
zahrada	Dhl	X
zahradník	Dh8	g
zdraví	Dic	g
zdravý	Di8	j
ze	Djf	c
zelený	Dj7	V
země	DkQ	l
zima	Dk1	i
zloděj	DlX	X
znovu	Dlu	q
zrcadlo	DmY	q
zvírě	DnC	l
zvíře	Dnn	b
záchod	DoC	d
záležitost	Dof	BG
západ	Dpl	m
zápalná bomba	DqL	r
září	Dq2	q
zítra	Drg	f
únor	Dr/	b
úraz	Dsa	a
úterý	Ds0	b
účet	DtP	d
účetní	Dts	l
úřad	DuR	o
čaj	Dyw	b
časem	DzL	p
často	Dz0	w
čech	Du5	Z
čechy	DvS	Z
černý	D0k	a
červen	D0+	b
červenec	D1Z	c
červený	D11	e
československo	Dvr	q
česká respublika	DwV	4
český	D2T	e
čina	DxN	p
člověk	D2x	n
člun	D3Y	Z
čokoláda	D3x	g
čtvrtek	D4R	l
čtyři	D42	d
čí	D5T	u
čísti	D6B	Y
řeka	D6Z	a
řezník	D6z	c
řím	Dx2	W
šedivý	D7P	e
šest	D7t	Z
škola	D8G	Y
španělsky	D8e	f
špatný	D89	1
špenát	D9y	f
špinavý	D+R	+
šunka	D/P	a
švagr	D/p	m
švýcarsko	DyM	k
žena	EAP	a
židle	EAp	X
žito	EBA	V
život	EBV	W
žlutý	EBr	a
