00databasealphabet	CFxH	6
00databasedictfmt1121	B	b
00databaseinfo	c	kt
00databaseshort	lJ	BC
00databaseurl	CFw/	I
00databaseutf8	A	B
10 y cant	Bcw8	j
a	BB8N	1
a	asm	a
abaci	BdMA	p
abacws	BXGI	q
aber	jur	n
aberdyfi	BDZl	k
aberoedd	jtc	r
abertawe	BDaJ	n
aberth	jvS	q
aberthau	jv8	r
aberthu	BkFI	p
aberu	BkFx	e
absennol	juH	k
absennu	BkGP	g
absenoldeb	jwn	s
absenoldebau	jxT	v
absoliwt	Hw9	l
ac	atd	R
ac ati	Bbse	BR
academaidd	atu	h
academi	BHg9	m
academydd	BD3O	2
academyddion	BQHd	4
academïau	BRtR	7
acen	jyC	q
acenion	jys	y
acennu	BkGv	f
acer	BXGy	p
aceri	BdMp	i
achlesu	BkHO	i
achlysur	jze	m
achlysuro	BkHw	j
achlysurol	auP	h
achlysuron	j0E	t
achos	j0x	k
achos cryf dros	BH9G	BO
achosi	BkIT	f
achosiant	G6f	t
achosion	j1V	v
achrededig	BD4E	r
achrediad	BD4v	0
achrediadau	BQIV	9
achredu	BjLH	f
achub	BkIy	c
achubiad	G7M	u
achwyn	BkJO	i
achwynwyr	j3g	u
achwynydd	j2E	r
achwynyddion	j2v	x
aciwt	BD5j	l
actio	BkJw	i
actor	j4O	r
actores	j5i	l
actoresau	j6H	t
actorion	j45	p
acw	auw	m
adain	j7a	p
adalw	BkLX	h
adalwad	m/	n
adalwadau	NDx	v
adar	j8n	j
adara	BkL4	h
adarfogi	BkMZ	k
adargraffu	BkM9	r
adborth	avW	w
adborthi	BjLm	n
adbryniad	UM/	4
adbryniadau	Xzh	6
adchwyddo	BkNo	j
addaliad	j94	q
addaliadau	j+i	r
addalu	BkKS	f
addas	awG	f
addasadwy	G76	v
addasedig	XBc	v
addasiad	BDr3	t
addasiad	j/N	w
addasiadau	BQA7	1
addasiadau	j/9	5
addasrwydd	awl	y
addasu	BkOL	b
addaswr	BD6I	+
addaswyr	BQJS	BN
addasydd	nm	s
addasydd	oS	t
addasyddion	NEg	1
addasyddion	NFV	0
addawol	axX	j
addef	BkOm	j
addewid	kA2	q
addewidion	kBg	z
addo	BkPJ	m
addoli	BkPv	i
addrefnu	BkKx	m
adduned	BD7G	5
addunedau	BQKf	BC
addunedu	BkQR	g
addurn	H4M	h
addurn	pt	p
addurnau	NG/	x
addurniad	o/	u
addurniadau	NGJ	2
addurniadol	H4t	y
addurno	BkQx	j
addysg	ax6	r
addysgiadol	ayl	q
addysgol	azP	p
addysgu	BkRU	h
addysgwr	BD7/	s
addysgwyr	BQLh	0
adeg	kCT	i
adegau	kC1	s
adeilad	kDh	q
adeiladaeth	qW	8
adeiladaethau	NHw	9
adeiladau	kEL	u
adeiladiad	sr	x
adeiladiadau	NKV	v
adeiladol	az4	z
adeiladu	BkR1	g
adeiladwaith	a0r	x
adeiledd	UN3	+
adeileddau	X0b	BH
adeileddu	Bju5	4
adeiledig	a1c	q
aden	BD8r	k
adeni	BkSV	o
adenillion	Wp4	4
adennill	BkS9	j
adenydd	BQMV	u
adenydd	j60	m
aderyn	j8D	k
adethol	BkTg	k
adfail	kFh	s
adfeddu	BkUE	t
adfeilio	BkUx	f
adfeilion	kE5	o
adfer	BkVQ	h
adferiad	kHA	r
adferiadau	kGN	z
adferu	BkVx	i
adfewnio	BkWT	l
adfywhau	BkW4	n
adfywiad	xvW	z
adfywiadau	kHr	0
adfywio	BkXf	j
adio	CFvo	f
adlais	rS	i
adlamu	BkYC	g
adleisiau	NIt	q
adleisio	BkYi	k
adleoli	BkZG	k
adlewyrchiad	kJS	4
adlewyrchiadau	kIf	z
adlewyrchu	BkZq	l
adlifo	BkaP	e
adloniant	zy+	z
adnabod	Bj93	t
adnabyddadwy	JdP	2
adnabyddedig	XAb	BB
adnabyddiad	UO1	9
adnabyddiadau	X1i	BI
adnabyddiaeth	Wqw	8
adnabyddus	a2G	x
adnau	BD9P	q
adneuo	Bkat	j
adneuon	BQND	s
adnewyddadwy	a23	x
adnewyddiad	tc	y
adnewyddiadau	NLE	5
adnewyddu	BhsW	o
adnewyddu	BkbQ	l
adnodd	kKK	0
adnoddau	kK+	x
adnoddu	Bkb1	o
adolygiad	kMZ	r
adolygiadau	kLv	q
adolygu	Bkcd	h
adran	kN5	r
adrannau	kNE	1
adrannol	a3o	t
adre	BD0B	q
adref	BD0r	n
adref	a4V	t
adrodd	Bkc+	g
adroddiad	kOk	p
adroddiad banc	BXIt	0
adroddiadau	kPN	o
adroddiadau banc	BdNL	7
aduno	Bkde	l
adwaith	kP1	r
adweinyddu	BkeD	s
adweithiau	kQg	2
adweithio	Bkev	m
adwerthu	BjM6	k
adwy	Bc7K	+
adwy neu	Bc9E	q
adwy nid	Bc9u	w
adwyau	BgxB	4
adwyau neu	Bgx5	1
adwyau nid	Bgyu	2
adysgrifio	BkfV	m
aeddfed	a5C	h
aeddfedrwydd	G8p	1
aeddfedu	Bkf7	i
aelod	kRW	n
aelodaeth	a5j	q
aelodau	kR9	s
aelodi	Bkgd	m
aelwyd	kSp	l
aelwydydd	kTO	t
aer	a6N	h
affeithio	BkhD	m
affrica	BDaw	s
afiechyd	kT7	p
afiechydon	kUk	x
aflonyddu	Bkhp	s
afloyw	H6C	g
aflunedd	UPy	6
afluneddau	X2q	BD
afluniad	UQs	9
afluniadau	X3t	BG
aflunio	Bg5P	1
aflunio	BkiV	m
aflwyddiannus	a6u	z
aflwyddo	Bki7	i
aflym	BXJh	m
afon	kVV	l
afonydd	kV6	t
afradloni	Bkjd	n
afradu	BkkE	k
afraid	XTc	BE
afrealistig	BD+e	n
afreidrwydd	Wxr	BF
afreolaidd	a7h	j
afresymol	a8E	v
afrwyddo	Bkko	m
ag	a8z	g
agen	vv	i
agenda	kWn	l
agendau	kXM	o
agennau	NNz	u
agennu	BklO	f
ageru	Bklt	i
agor	BkmP	d
agored	a9T	j
agoredig	H6i	p
agoriad	kX0	j
agoriadau	kYX	o
agoriadol	a92	h
agos	a+X	d
agosach	a+0	p
agosaf	a/d	h
agosáu	Bkms	k
agwedd	kY/	m
agweddau	kZl	x
ai	a/+	Y
aifft	BDbc	p
ail	BW0D	h
ail isradd	V4O	5
ail israddau	Zqi	BC
ailaddurno	BkpC	p
ailadeiladu	Bkpr	q
ailadrodd	BkqV	r
ailadroddiad	wR	4
ailadroddiadau	NOh	/
ailadroddydd	u4	3
ailadroddyddion	NM1	+
ailarchebu	BjMN	t
ailarfogi	BkrA	o
ailargraffiad	BD/F	u
ailargraffiadau	BQNv	3
ailargraffu	Bkro	s
ailasesu	BksU	v
ailbacio	BktD	k
ailbeintio	Bktn	s
ailbenodi	BkuT	v
ailblannu	BkvC	p
ailboblogi	Bkvr	p
ailbriodi	BkwU	p
ailbroffilio	Bkw9	w
ailbrofi	Bkxt	q
ailchwarae	BkyX	t
ailchwyddo	BkzE	r
aildargedu	Bkzv	v
ailddangos	BhlW	m
ailddarlledu	Bk0e	u
ailddarllen	Bk1M	o
ailddatblygu	Bk10	s
ailddatgan	Bk2g	t
ailddatganu	Bk3N	v
ailddechrau	Bk38	q
ailddefnyddio	Bk4m	v
aildderbyn	Bk5V	p
ailddewis	Bk5+	s
ailddiffinio	Bk6q	u
ailddigwydd	Bhl8	m
ailddirwyn	BiFN	t
ailddirwyn	Bk7Y	u
ailddiwygio	Bk8G	s
ailddodrefnu	Bk8y	s
ailddosrannu	Bk9e	y
ailddrafftio	Bk+Q	s
ailddweud	Bk+8	s
ailddyblu	Bk/o	u
ailddyfeisio	BlAW	w
ailddylunio	Bhmi	n
ailddymunoli	BhLt	BW
ailddysgu	BlBG	r
aildeipio	BlBx	m
aildrefnu	BlCX	p
aildrosedd	BD/z	1
aildroseddau	BQOm	z
aildroseddu	BlDA	x
aildyfu	BlDx	l
ailedrych	BlEW	r
aileni	BlFB	n
ailennill	BlFo	s
ailennyn	BjNe	k
ailenwi	BhnJ	j
ailfeddiannu	BlGU	q
ailfeddwl	BlG+	m
ailfedyddio	BlHk	o
ailfeintio	BjEZ	n
ailfformatio	BlIM	r
ailffurfweddu	Bhns	v
ailflagura	BlI3	v
ailfodelu	BjOC	l
ailfreinio	BlJm	w
ailfuddsoddi	BlKW	w
ailfwyta	BlLG	r
ailfynegi	BlLx	r
ailfywhau	BlMc	q
ailfywio	Bhob	p
ailfywiogi	BlNG	x
ailgasglu	BlN3	n
ailgenhedlu	BlOe	v
ailgloddio	BlPN	p
ailgloriannu	BlP2	z
ailgodi	BlQp	n
ailgoncro	BlRQ	v
ailgreu	BlR/	p
ailgrynhoi	BhpE	x
ailgwympo	BlSo	w
ailgychwyn	Bhp1	m
ailgyfansoddi	BlTY	t
ailgyfeiriad	yB	7
ailgyfeiriadau	NQX	BB
ailgyfeirio	Bhs+	w
ailgyfeirio	BlUF	r
ailgyflogi	BlUw	m
ailgyflunio	BjPX	r
ailgyflwyno	BlVW	u
ailgyfodi	BlWE	x
ailgyfrifo	Bhqb	z
ailgyhoeddi	BlW1	y
ailgylchadwy	BEAo	1
ailgylchu	BlXn	u
ailgylchynu	BlYV	v
ailgymeradwyo	BjOn	w
ailgymodi	BlZE	0
ailgynefino	BlZ4	7
ailgynhyrchu	BjQp	v
ailgynllunio	Blaz	p
ailgynnau	BjRY	z
ailgynnig	Blbc	t
ailgynnull	BlcJ	w
ailgysegru	Blc5	1
ailgysgu	Bldu	z
ailgysodi	Bleh	r
ailgysylltu	BlfM	t
ailgyweirio	Blf5	t
ailgywiro	Blgm	q
ailhyfforddi	BlhQ	v
ailhyfforddiant	BE1U	y
aillansio	BknQ	m
ailledaenu	Bkn2	p
aillunio	Bkof	j
ailnegodi	BjUy	s
ailosod	Blh/	p
ailosodiad	y8	w
ailosodiadau	NRY	2
ailraddio	Blio	u
ailrannu	BljW	w
ailrestru	BlkG	r
ailrifo	Bg6E	t
ailrybuddio	Blkx	r
ailsefydlu	Bllc	u
ailsefyll	BlmK	p
ailsianelu	Blmz	q
ailstorio	Blnd	y
ailstrwythuro	BloP	z
ailwampio	BlpC	n
ailweirio	Blpp	p
ailweithredu	Bg6x	BD
ailwerthu	BlqS	m
ailwirio	Blq4	v
ailwladychu	Blrn	r
ailwneud	BhrO	i
ailwrando	BlsS	t
ailymaelodi	Bls/	o
ailymddangos	Bltn	r
ailymgeisio	BluS	t
ailymgynnull	BjVe	y
ailymgynull	Blu/	t
ailymosod	Blvs	w
ailymrwymo	Blwc	2
ailymuno	BlxS	s
ailysgogi	Blx+	w
ailysgrifeniad	G4e	7
ailysgrifeniadau	UGs	BP
ailysgwyddo	Blyu	w
ailystyried	Blze	w
ailyswirio	Bl0O	t
alaethu	Bl07	q
alaru	Bl1l	n
alban	BDcF	m
albwm	BBvS	h
albymau	BBuq	o
alcohol	bAW	o
alffa	G9e	f
alffagyfuniad	G99	+
alffarifol	H7s	v
algebra	BXLq	x
algorithm	07	v
algorithmau	NUC	0
aliniad	1q	q
aliniadau	NU2	x
alinio	Bl2M	n
allan	bA+	W
allanadlu	Bl2z	r
allanfa	URp	z
allanfeydd	X4z	7
allanol	bBU	j
allanu	Bl3e	f
allbwn	kaW	o
allbynnau	ka+	t
allbynnu	Bl39	f
alldro	BFJh	/
alldynnu	BhuZ	h
allforedig	H8b	u
allforiad	23	q
allforiadau	NWW	z
allforio	Bl4c	i
allfudo	Bl4+	m
allfwrw	Bhu6	l
allfynd	H9J	i
allgofnodi	Bl5k	j
allgyrsiol	BE0h	z
alllein	IrR	j
allolchi	Bl6H	l
alltudio	Bl6s	i
allwedd	2U	j
allwedd	kcQ	m
allweddair	3h	v
allweddau	kbr	l
allweddeiriau	NXJ	x
allweddell	USc	3
allweddellau	X5u	BA
allweddi	NVn	v
allweddi	jkR	t
allweddol	bB3	c
allweddu	Bl7O	h
allyrru	Bl7v	n
almaen	BDcr	k
almaeneg	bCT	h
am	bC0	c
amaeth	bDQ	u
amaethu	Bl8W	k
amaethyddiaeth	bD+	s
amaethyddol	bEq	q
amau	Bl86	g
amau	jk+	p
ambell	bIN	j
ambiwlans	kc2	v
ambiwlansys	kdl	u
amcan	kfB	u
amcangyfrif	Bl9a	p
amcangyfrif	keT	u
amcangyfrifol	H9r	0
amcangyfrifon	kgh	s
amcanion	kfv	y
amcanu	Bl+D	d
amdanaf	H+f	f
amdani	bFU	t
amdano	bGB	p
amdanoch	BBis	x
amdanom	bGq	f
amdanyn	bHJ	h
amdanynt	bHq	j
amddifad	H++	l
amddifadedd	bXb	w
amddifadu	Bl+g	l
amddiffyn	Bl/F	f
amddiffynfa	khN	t
amddiffynfeydd	kh6	8
amddiffyniad	bIw	t
amddiffynnol	bJd	n
america	BDdP	l
americanaidd	bKE	u
amfesur	BXNM	z
amfesurau	BdPH	q
amffiniedig	H/j	w
amffinio	BiZ5	k
amffinydd	4Q	u
amffinyddion	NX6	5
amgaead	BV7t	u
amgaeadau	BWMj	z
amgaeedig	IAT	u
amgaeëdig	bKy	t
amgaëedig	Myu	z
amgen	bLf	s
amgenu	BhwR	r
amgodiad	5+	s
amgodiadau	NaN	s
amgodio	BmAL	f
amgodydd	6q	s
amgodyddion	Na5	s
amgrwm	IBB	f
amgryptiedig	ICa	y
amgryptio	BmAq	r
amgueddfa	ki2	u
amgueddfeydd	kjk	3
amgyffred	BmBV	p
amgyffred	bML	5
amgylch	bNE	n
amgylchedd	kkb	1
amgylcheddau	klQ	9
amgylcheddol	bNr	v
amgylchfyd	bOa	u
amgylchiad	kmN	z
amgylchiadau	knA	8
amgylchu	BmB+	i
amgylchynu	BmCg	o
amgáu	Bi/I	q
amgáu	Bl/k	n
amharchu	BmDI	o
amharchus	BOgV	v
amharod	BEz8	l
amharu	BmDw	h
amhenodol	IDM	u
amherthnasol	ID6	4
amherthnasol	IFi	z
amheuaeth	kn8	u
amheuon	koq	1
amheus	bPI	t
amhleidiol	J36	r
amhoradwy	IEy	w
amhosib	bP1	o
amhosibl	bQd	l
amhriodol	bRC	m
amhwyllo	BmER	j
aml	bRo	h
amlach	BGUD	k
amlaf	bSJ	p
amlap	BDmt	7
amlapiau	BP7p	5
amlapio	BmE0	s
amlasiantaethol	BE2G	0
amlben	BCco	BJ
amlblecsio	Bhw8	o
amlblecsydd	7W	0
amlblecsyddion	Nbl	9
amlbroffesiynol	BFKg	/
amlbwrpas	BE5p	5
amlchwaraeon	BFLf	q
amlchwaraewr	IGV	y
amlddefnydd	BE26	z
amlddisgyblaethol	BE4s	9
amlddiwylliannol	BE3t	/
amlder	/Ne	BJ
amledd	9I	n
amleddau	Ndj	3
amlen	kqN	o
amlenni	kpf	u
amlhau	BmFg	h
amliaith	BFMJ	3
amlin	9v	j
amlinell	UTT	w
amlinellau	X6u	4
amlinelliad	kq1	s
amlinelliad dangosol	BH7O	BK
amlinelliadau	krh	s
amlinelliadau dangosol	BR+x	BZ
amlinellu	BmGB	i
amliniau	Nea	3
amlochron	+S	s
amlochronnau	NfR	w
amlosgi	BmGj	j
amlran	IHH	g
amlwg	bSy	a
amlycaf	bTM	j
amlygedig	IIL	w
amlygiad	BAZ	v
amlygiadau	Nhn	4
amlygrwydd	BFNA	BC
amlygu	BiKM	k
amlygu	BmHG	f
amneidio	BmHl	d
amnewid	BmIC	n
amnewidiad	BCY	1
amnewidiadau	NkJ	2
amod	ks+	0
amodau	ksN	x
amodi	BmIp	j
amodol	bTv	j
amorteiddiad	BDN	6
amorteiddiadau	Nk/	8
amorteiddio	Bhy3	n
amrant	Ekv	j
amrantau	Rg1	w
amrantol	IJn	k
amrantu	BmJM	f
amrediad	kty	n
amrediadau	kuZ	m
amrwd	bUS	b
amryfal	ku/	k
amryfuso	BmJr	h
amryw	bUt	g
amrywiad	kwZ	q
amrywiadau	kvj	2
amrywiadwy	BFOC	o
amrywiaeth	kx6	r
amrywiaethau	kxD	3
amrywio	BmKM	f
amrywiol	bVN	h
amser	kyl	s
amserau	kzR	q
amseredig	ILB	p
amserfa	BBI	o
amserfeydd	Nif	2
amseriad	BFOq	s
amseriadau	BQrs	3
amserlen	k0m	r
amserlenni	kz7	r
amserllawn	bVu	l
amsernod	M5H	l
amsernodau	UJu	s
amseroedd	+4n	p
amserol	bWT	i
amseroldeb	BFPW	2
amserreal	BE6i	4
amseru	BmKr	d
amserydd	BBw	o
amserydd tywod	BXN/	5
amseryddion	NjV	0
amseryddion tywod	BdPx	0
amsugno	BmLI	g
amwisgo	BmLo	n
amwys	ILq	f
amynedd	G+7	p
amyneddgar	II7	s
anabl	bW1	m
anabledd	k2H	t
anableddau	k1R	2
anablu	BhyQ	n
anad	bYL	d
anaddas	bYo	x
anaddasedig	IMq	x
anaddasu	BmMP	m
anadferadwy	INb	1
anadl	k3j	m
anadlau	k20	v
anadlon	k4J	o
anadlu	BmM1	g
anadnabyddadwy	JcP	BA
anadnabyddus	IOQ	z
anaf	k4x	f
anafiadau	k5Q	o
anafu	BmNV	g
anallu	BFQM	p
analluog	XmD	6
analluogi	BmN1	l
analog	IMJ	h
anaml	bZZ	e
ananghynhwysol	BFQ1	2
anarferedig	IQC	w
anarferol	bZ3	l
anargaeledd	BFTR	9
anarwyddocaol	IQy	8
anawdurdodedig	IRu	+
anawsterau	k6g	2
andros	ISs	l
andwyo	BmOa	k
andwyol	bac	e
anecdot	BE7a	s
anecdotau	BQl1	3
aneddiadau	k8F	1
aneffeithiolrwydd	BFUO	BF
aneffeithlon	BFVT	z
aneffeithlonrwydd	BFWG	BF
aneglur	ba6	m
anelu	BmO+	a
anerchion	k86	u
anesmwytho	BmPY	t
anfantais	k/N	t
anfanteision	k+Z	0
anfarwoli	BmQF	v
anfeidredd	G/k	w
anfeidrol	ITR	o
anferth	bbg	f
anfesuradwy	BFXL	3
anffafriol	BFYC	4
anffodus	bb/	o
anffurfio	BmQ0	i
anffurfiol	bcn	l
anfoddhaol	bdM	t
anfoddio	BmRW	j
anfoddog	BFZ6	m
anfodlon	bd5	n
anfodloni	BmR5	t
anfodlonrwydd	BFY6	BA
anfon	BmSm	h
anfoneb	lAs	p
anfonebau	k/6	y
anfonebedig	BFag	w
anfonebu	BmTH	k
anfonedig	IT5	o
anfonwr	BG+	n
anfonwyr	NpS	x
anfri	BFbQ	r
anfriau	BQsj	w
anfwriadol	IUh	z
angau	lEt	o
angel	v67	j
angen	lCr	k
angenrheidiau	NqD	BA
angenrheidiau	lD+	v
angenrheidiol	beg	y
angenrheidrwydd	BFiq	3
angerdd	BFjh	BG
anghenion	lCD	o
anghenraid	lDP	v
anghenrhaid	BHl	0
anghenus	BFkn	t
angheuoedd	lFV	1
angheuol	IVU	j
anghoelio	BmTr	p
anghofio	BmUU	n
anghredu	BmU7	j
anghydamseredig	IPD	/
anghydbwysedd	BFlU	v
anghydfod	lG5	v
anghydfodau	lGK	v
anghydnaws	IV3	t
anghydnawsedd	BIZ	/
anghydnawseddau	NrD	7
anghydraddoldeb	lHo	7
anghydraddoldebau	lIj	5
anghydsynio	BmVe	r
anghydwedd	JDx	t
anghydweddau	OaV	4
anghydweddiad	Bx+	4
anghydweld	BmWJ	p
anghyfaddasu	BmWy	s
anghyfartal	BFmD	n
anghyfarwydd	bfS	r
anghyffredin	bf9	y
anghyfiawnder	lJc	7
anghyfiawnderau	lKX	BE
anghyflawn	IWk	r
anghyfleus	IXP	u
anghyfleuster	BKR	+
anghyfleusterau	Ns+	BE
anghyfochrog	BXKH	y
anghyfrannol	IX9	3
anghyfreithlon	bgv	w
anghymeradwyaeth	BFmq	+
anghymeradwyo	BmXe	t
anghymesur	BXK5	x
anghymhwyso	BmYL	w
anghynhwysol	BFRr	n
anghynhwysol	IZf	1
anghynrychiadol	BFqi	BD
anghynrychioliadol	BFpe	BE
anghynwysoldeb	BFSS	/
anghyrhaeddol	IaU	2
anghysbell	bhf	s
anghyson	biL	z
anghysondeb	VrO	BG
anghysondebau	ZdI	BO
anghysonedd	BJY	5
anghysoneddau	Nr+	BA
anghysuro	BmY7	p
anghytbwys	IbK	r
anghytundeb	BFrl	BE
anghytundebau	BQuM	BH
anghytuno	BmZk	v
anghytûn	Ib1	q
anghywir	bi+	o
angladd	lLb	y
angladdau	apm	r
angori	BmaT	s
angylion	lBV	u
anhafal	BXO4	i
anhapus	BENj	m
anhawster	k54	o
anheddau	lMN	3
anheddiad	k7W	v
anhepgor	BHlq	m
anhepgorol	BFtl	y
anhraddodiadol	BFsp	8
anhrefn	bjm	q
anhrefnu	Bma/	t
anhuddo	Bmbs	p
anhwylder	lOZ	o
anhwylderau	lNq	v
anhwyluso	BmcV	x
anhyblyg	BXPa	o
anhyfrydu	BmdG	r
anhygoel	bkQ	n
anhysbys	bk3	i
anialwch	blZ	v
anifail	lP0	p
anifeileiddio	Bmdx	r
anifeiliaid	lPB	z
animeiddiad	BLP	1
animeiddiadau	NuC	8
animeiddio	IdU	s
anleol	IeA	j
anlladu	Bmec	s
annarllenadwy	Iej	2
annatod	bmI	k
annedd	lNE	m
annegatif	IfZ	u
annerbyniol	bms	q
annerch	BmfI	p
annerch	k9o	x
annhebyg	bn7	t
annhebygol	bnW	l
annheg	boo	n
annibyniaeth	lQd	6
annibynnol	bpP	s
annibynnwr	BFuX	7
annibynwyr	BQvT	4
anniffiniedig	Icf	1
annifyr	IgH	k
annigonol	bp7	o
annigonolrwydd	BFvS	5
annilys	Igr	j
annisgwyl	bqj	t
annoeth	BFwL	n
annog	Bmfx	i
annos	BmgT	r
annwyl	brQ	k
annymunol	BEOJ	k
annymunol	IhO	s
anobeithio	Bmg+	n
anochel	br0	o
anodd	bsc	g
anoddach	HzV	q
anodi	Bmhl	f
anogaeth	lSI	2
anogaethau	lRX	x
anogiad	UV2	1
anogiadau	X9l	7
anogiaeth	BME	0
anogiaethau	Nu+	/
anorchfygol	BbSL	s
anorfod	bs8	m
anorthrech	BFwy	2
anos	BGVv	l
anrheg	lS+	v
anrhegion	lTt	v
anrhegu	BmiE	g
anrheithio	Bmik	i
anrhydedd	lUc	o
anrhydeddau	lVE	w
anrhydeddu	BmjG	r
anrhydeddus	BFyT	t
ansad	Ih6	d
ansadrwydd	BWD	x
ansafonol	IiX	t
ansawdd	lV0	q
ansefydlogi	Bmjx	m
ansefydlu	BmkX	r
ansicr	bti	g
ansicrwydd	buC	v
ansoddair	BJwt	z
ansoddau	lWe	z
ansoddeiriau	BS2n	3
ansoddol	BFzA	u
anstatudol	BFxo	r
antur	lX8	q
anturiaeth	lZZ	q
anturiaethau	lYm	z
anturiau	lXR	r
anturio	BmlC	m
anufuddhau	Bmlo	s
anuniongred	BOhE	/
anuniongyrchol	bux	o
anurddo	BmmU	6
anwadalu	BmnO	q
anwag	IjE	f
anweddu	Bmn4	m
anweithred	BFzu	+
anweithredol	bvZ	r
anweithredoli	Bhze	u
anweledig	Ijj	t
anwes	laD	y
anwesau	la1	y
anwesu	Bmoe	o
anwir	BFAd	q
anwireddu	BmpG	k
anwybodaeth	Bc/H	7
anwybyddu	Bmpq	l
anwylo	BmqP	h
anwytho	Bmqw	h
anymddiheurol	BPWm	BO
anymddiheurol o besimistaidd	BPX0	BI
anymddiried	BmrR	t
anystwytho	Bmr+	q
ap	bwE	m
apelau	lc0	k
apeliad	ldY	u
apeliadau	lcK	q
apelio	Bmso	f
apeliwr	leG	p
apelwyr	lev	q
apelydd	lgG	q
apelyddion	lfZ	t
apig	BV8b	n
apigau	BWNW	u
apwyntiad	lgw	0
apwyntiadau	lhk	x
apwyntio	BmtH	j
apêl	lbn	j
ar	bwq	i
ar adnau	BD95	l
ar ben	BXQC	k
ar ddisberod	BOLt	p
ar draul	KEw	t
ar draws	BXQm	t
ar eu liwt eu hunain	BKma	Bi
ar frys	Kp5	i
ar goedd	BJRZ	o
ar gyfartaledd	BXRT	t
ar gyfer	BVjG	d
ar hap	BO0S	m
ar oledd	BXE5	v
ar oledd	BZVw	k
ar un adeg	BG0h	w
ar unrhyw adeg	BGxE	t
ar wasgar	MrY	h
ar werth	BXSA	m
ar y goriwaered	BPgm	s
ar y gweill	BJ1d	0
ar y gweill	fmI	t
aradru	Bmtq	o
arae	BM4	g
araeau	Nv9	z
araf	bxM	V
arafach	IkQ	h
arafaf	BXSm	f
arafeisymud	BEOt	z
arafu	BmuS	o
araith	ljB	v
arall	bxh	X
aralleirio	Bmu6	n
arallgyfeirio	Bmvh	q
arbed	BmwL	b
arbedion	BE+T	q
arbedydd sgrin	BNY	BA
arbedyddion sgrin	Nww	BA
arbelydru	Bmwm	m
arbenigedd	bx4	o
arbenigo	BmxM	s
arbenigol	byg	j
arbenigwr	lki	r
arbenigwyr	ljw	y
arbennig	bzD	r
arbrawf	llN	z
arbrofi	Bmx4	w
arbrofiad	BOY	v
arbrofiadau	Nxw	w
arbrofion	lmA	x
arbrofol	bzu	v
arc	CNd	a
arcau	O5h	s
arch	lnW	n
archaeolegol	BE+9	t
archeb	lpv	i
archeb bost	BXTF	x
archebion	lpF	q
archebion post	BdQl	BF
archebu	Bmyo	d
archeolegol	b0d	v
archfarchnad	BE/q	z
archfarchnadoedd	BQoH	/
archif	lok	h
archifau	ln9	n
archifo	BmzF	n
archifydd	BF0s	u
archifyddion	BQwL	v
archolladwy	Ikx	x
archolli	Bmzs	n
archwaethu	Bm0T	l
archwiliad	lq/	m
archwiliadau	lqR	u
archwiliedig	Ili	v
archwilio	Bh01	g
archwilio	Bm04	k
archwiliwr	lsa	t
archwilwyr	lrl	1
ardal	Bbdj	+
ardal	ltH	o
ardalau	HAU	n
ardaloedd	ltv	t
arddangos	Bh0M	p
arddangos	Bm1c	k
arddangosedig	ImR	1
arddangosfa	lvL	x
arddangosfeydd	luc	v
arddangosiad	BRL	x
arddangosiad	Uaf	BA
arddangosiadau	N1M	v
arddangosiadau	YCy	BG
arddangosol	InG	q
arddangosydd	UYk	/
arddangosyddion	YAn	BI
arddel	Bm2A	l
ardderchog	b1M	p
arddodi	Bm2l	k
arddull	lww	r
arddulliau	lv8	0
arddullio	Bm3J	k
arddweud	Bm3t	k
ardrefniannau	X+g	BC
ardrefniant	UWr	/
ardystiedig	J5q	x
ardystio	BiHy	o
ardystio	Bm4R	g
aredig	Bm4x	h
aredig	Bm5S	k
areithiau	liV	s
areithio	Bm52	q
arestio	Bm6g	i
arf	lyH	j
arfaeth	BF2J	q
arfaethau	BQx1	3
arfaethedig	b11	w
arfaethu	Bm7C	j
arfarniad	BF2z	w
arfarniadau	BQys	2
arfarnu	BjWQ	f
arfau	lxb	s
arfer	BDjA	n
arfer	Bm7l	d
arfer gorau	BH5q	1
arferadwy	BF3j	l
arferiad	/fQ	9
arferiadau	/eT	9
arferion	BDiV	r
arferion gorau	BR8+	7
arferol	b2l	j
arferu	Bm8C	p
arfog	b3I	o
arfogi	Bm8r	d
arfordir	lzT	h
arfordiroedd	lyq	p
arfordirol	b3w	l
argaeledd	b4V	t
argeisio	Bm9I	i
arglwydd	BF4I	m
arglwyddi	BQzi	v
arglwyddiaethu	Bm9q	l
argraff	l0s	s
argraffadwy	Inw	w
argraffadwy dyfynedig	Ir0	BV
argraffadwy dyfynedig	KNv	BV
argraffau	lz0	4
argraffedig	Iog	u
argraffiad	l2K	p
argraffiadau	l1Y	y
argraffu	Bm+P	g
argraffuaralw	BFBH	z
argraffwr	BFB6	n
argraffwyr	BQpG	x
argraffydd	BPH	w
argraffyddion	Nyg	BB
argyfwng	l3r	v
argyfyngau	l2z	4
argyfyngus	IpO	t
argyhoeddi	Bm+v	n
argyhoeddiadol	BFCh	3
argymell	Bm/W	o
argymelledig	Ip7	3
argymhelliad	l6P	BC
argymhelliadau	l4a	+
argymhellion	l5Y	3
arholi	Bm/+	t
arholiad	l8K	1
arholiadau	l7R	5
arholwr	l9y	p
arholwyr	l8/	z
arhosiad	BFDY	q
arhosiadau	BQp3	2
arhosol	BF4u	r
arian	b8P	h
arian cywir	BXUu	z
arian papur	BXT2	4
arian parod	BXVh	p
arian poced	BXWK	2
arian tramor	BXXA	7
ariannin	BDd0	r
ariannin	HA7	r
ariannol	b8w	i
ariannu	BnAr	l
arithmetig	HBm	1
arlein	Iqy	f
arlein	b9S	d
arlliw	BP3	i
arlliw	Wrs	4
arlliwiau	Nzh	x
arlliwio	Bg9U	u
arlliwio	Bh1V	o
arllwys	BnBQ	n
arloesedd	BF5Z	u
arloesi	BnB3	k
arloesol	b9v	m
arlunio	BnCb	f
arlunwyr	l/E	p
arlunydd	l+b	p
arlwyo	BnC6	e
arna	b5C	k
arnaf	b5m	i
arnat	/On	u
arni	b6I	Z
arno	b6h	a
arnoch	BBjd	k
arnofio	BnDY	f
arnom	b67	a
arnyn	b7V	c
arnynt	b7x	e
arogl	mAX	n
aroglau	l/t	q
aroglau	mBo	k
arogldarth	BV1e	p
arogldarthau	BWKc	v
arogldarthu	BnD3	s
arogleuon	mA+	q
arogli	BnEj	h
arolwg	Gnn	o
arolwg	mC8	n
arolygiad	mEY	t
arolygiadau	mDj	1
arolygiaeth	BF6H	y
arolygiaethau	BQ0R	7
arolygol	b+V	l
arolygon	Tz/	t
arolygon	mCM	w
arolygu	BnFE	j
arolygwr	mF9	w
arolygwyr	mFF	4
arolygydd	mGt	y
arolygyddion	mHf	y
aros	BjI5	d
aros	BnFn	d
arsefydliad	Xwn	BH
arsefydliadau	akF	BL
arsefydlu	Bg+C	7
arsefydlydd	UXq	6
arsefydlyddion	X/i	BF
arswydo	BnGE	n
arsyllu	BnGr	f
arsylwad	BYth	+
arsylwadau	BeL5	BX
arsylwi	BnHK	m
arteithio	BnHw	g
arthio	BnIQ	f
artiffisial	b+6	r
artist	mJC	w
artistiaid	mIR	x
artistig	b/l	p
arunigo	BnIv	i
arunigol	Izb	s
aruthrol	MYS	p
aruthrol	cAO	r
arwahanol	I0H	o
arwahanrwydd	BF65	y
arwain	BnJR	e
arweddu	BnJv	i
arweiniad	+65	s
arweiniad	C/l	q
arweiniadau	PzN	0
arweiniol	I0v	n
arweiniol	cBY	s
arweinwyr	mJy	t
arweinydd	BG1R	w
arweinydd	mKf	n
arweinyddiaeth	BF7r	7
arweinyddiaethau	BQ1M	4
arweinyddion	BRTj	v
arweinyddol	BF8m	v
arwerthiannau	BVVa	5
arwerthiant	BP6+	r
arwerthu	BnKR	h
arwisgo	BnKy	m
arwr	mLu	l
arwydd	mM5	h
arwydd hafal	BXYy	+
arwyddair	BHk3	z
arwyddeiriau	BRvY	z
arwyddion	mMT	m
arwyddion hafal	BdRq	BH
arwyddo	BnLY	d
arwyddocaol	cCy	t
arwyddocáu	BnL1	n
arwyddocâd	cCE	u
arwyneb	mOH	m
arwyneb crwm	BXZw	6
arwyneb gwastad	BXaq	7
arwyneb plân	BXbl	+
arwynebau	mNa	t
arwynebau crwm	BdSx	+
arwynebau gwastad	BdTv	BJ
arwynebau plân	BdU4	BB
arwynebedd	/gN	5
arwynebeddau	BXcj	8
arwyr	mLG	o
arwystl	BF9V	BA
arwystlo	BnMc	j
arwystlon	BQ2E	BA
as	cDf	j
asbestos	cEC	0
ased	BE9m	t
ased	mPZ	j
asedau	mOt	s
asedion	BQnc	r
aseiniad	mQr	r
aseiniadau	mP8	v
asesiad	mSN	s
asesiadau	mRW	3
asesu	BnM/	g
aseswyr	mTp	q
asesydd	mS5	w
asetig	ItJ	g
asetylsalisylig	Itp	BC
asgell	BYv	j
asgwrn	mU5	l
asgwrneiddio	BnNf	m
asiant	mVe	l
asiantaeth	mXX	q
asiantaethau	mWp	u
asiantau	mWD	m
asid	mYB	q
asidau	mYr	o
asideiddio	BnOF	r
asio	BnOw	d
astroleg	HD0	t
astudiaeth	mZ/	p
astudiaethau	mZT	s
astudio	BnPN	f
asur	I1W	c
at	cE2	U
at hynny	BbRN	+
ataf	cFK	e
atafaelu	BnPs	s
atal	BnQY	m
ataliad	BZ9	p
ataliadau	N+T	u
ataliol	BF+V	s
atalnod	Bam	l
atalnod llawn	BbL	4
atalnodau	N/B	o
atalnodau llawn	N/p	5
atalnodi	BnQ+	k
atchwelyd	BnRi	m
ateb	BnSI	i
ateb	mbZ	q
ateb bras	BXdf	BC
ateb yr un diben	BdC8	BD
atebion	mao	x
atebion bras	BdV5	BL
atebol	cFo	d
atebolrwydd	cGF	u
ategion	OAi	t
ategol	cGz	j
ategu	BnSq	b
ategyn	BcD	n
atglafychu	BnTF	y
atgnoi	BnT3	n
atgof	Bcq	l
atgoffa	BnUe	d
atgoffaol	I2Y	v
atgoffáu	BnU7	j
atgofion	OBP	5
atgryfhau	BnVe	w
atgyfannu	BnWO	o
atgyflyru	BnW2	o
atgyfnerthu	BnXe	q
atgyfodi	BnYI	o
atgynhyrchu	BnYw	t
atgyweiriad	mcD	s
atgyweiriadau	mcv	q
atgyweirio	BnZd	q
ath	/PV	n
athletau	BE87	r
athrawes	BBkw	q
athrawesau	BBkB	v
athrawiaethu	BnaH	0
athrawon	mdZ	y
athreiddio	Bna7	t
athro	BBla	x
athrodi	Bnbo	p
athrofa	BF/B	2
athrofaoedd	BQ3E	/
athroniaeth	cHW	2
athroniaethu	BncR	0
athronyddu	BndF	z
ati	cIM	e
atmosffer	BdP	u
atmosfferau	OCI	y
ato	cIq	i
atoch	BBmL	l
atodedig	I3H	q
atodi	Bnd4	j
atodiad	BBWp	BD
atodiadau	BBXs	BD
atodlen	mfH	s
atodlenni	meL	8
atodol	cJM	i
atolygu	Bneb	j
atom	cJu	Y
atomeiddio	Bne+	u
atomig	I3x	g
atred	Bd9	i
atredau	OC6	r
atsain	Bef	i
atseiniau	ODl	v
atseinio	Bnfs	p
atwrneiaeth	BF/3	w
atyfu	BngV	e
atyniad	mgm	r
atyniadau	mfz	z
atynnu	Bngz	l
atynt	cKG	g
aur	cKm	d
awchlymu	BnhY	q
awchu	BniC	f
awdio	I4R	c
awdiolegydd	BE8G	1
awdiolegyddion	BQms	w
awdl	mh8	g
awdlau	mhR	r
awdur	mjD	h
awdurdod	mkX	q
awdurdodaeth	cLD	z
awdurdodaidd	BGAn	t
awdurdodau	mjk	z
awdurdodedig	cL2	l
awdurdodi	Bnih	k
awdurdodiad	ml+	0
awdurdodiadau	mlB	9
awdurdodol	cMb	2
awdures	BF1a	v
awduresau	BQw6	7
awduron	mic	n
awel	mnm	s
awelon	mmy	0
awen	mo3	f
awenau	moS	l
awenyddu	BnjF	i
awgrym	+6S	n
awgrymiad	mqG	q
awgrymiadau	mpW	w
awgrymu	Bnjn	j
awr	mrf	k
awrgrymedig	I4t	z
awrol	I5g	d
awrwydr	BfB	q
awrwydrau	OEU	v
awst	BDUS	f
awstralia	BDef	v
awtistiaeth	cNR	3
awto	I59	Z
awtomatiaeth	HwE	5
awtomatig	M0S	v
awtomatig	cOI	u
awtomeiddio	BjBR	m
awydd	cO2	r
awyddu	BnkK	d
awyddus	cPh	m
awyr	cQH	f
awyren	msD	n
awyrennau	msq	o
awyrgylch	cQm	v
awyro	Bnkn	p
ayyb	cRV	Y
baban	mt5	p
babanod	mtS	n
babanu	BnlQ	k
babi	mui	i
bach	cRt	g
bachgen	mvo	j
bachu	Bnl0	f
bacio	BnmT	d
bacsu	Bnmw	m
bae	mww	i
baeau	mwL	l
baeddu	BnnW	c
baetio	Bnny	d
bag	cSN	d
bagadu	BnoP	e
bagiau	mxS	j
bagio	Bnot	Z
baglu	BnpG	d
bai	myW	k
baich	mzi	g
balch	Kal	Z
balchder	cSq	k
baldorddi	Bnpj	j
ban	m0q	f
banc	cTO	g
bancawio	BnqG	i
banciau	m1J	k
bancio	Bnqo	f
band	m2N	h
bandiau	m1t	g
baner	m3z	j
banerau	m2u	l
baneri	m3T	g
baneru	BnrH	f
bannau	m0C	o
bar	+4A	n
bar noddfa	FVO	w
bara	BbxD	j
bara brith	Bbxm	9
bara gwenith	BbwS	x
barbareiddio	Bnrm	r
barbio	BnsR	l
barcud	BXeh	v
barcudau	BdXE	1
barcuta	Bns2	j
bardd	m5b	h
bardd llawryfog	BKtZ	/
barddas	BEPg	9
barddoni	BntZ	n
barddoniaeth	cTu	r
bargeinio	BnuA	s
bargeinion	BQWC	0
bargen	BEQd	v
bargodi	Bnus	g
bariau noddfa	SVb	z
bario	BnvM	b
barn	m6j	h
barnau	m58	n
barneisio	Bnvn	l
barnu	BnwM	i
barnwr	m7p	g
barnwrol	cUZ	i
barnwyr	m7E	l
barrau	m4W	j
barugo	Bnwu	m
bas	BXfQ	o
bas	cU7	h
basach	BXf4	t
basaf	BXgl	p
basged	Bg6	l
basged grog	BG2B	+
basgedi	OGe	s
basgedi crog	BRUS	6
basgedu	BnxU	n
bat	UdW	t
bath	m8t	g
bathau	m8J	k
bathodi	Bnx7	i
bathu	Bnyd	a
batiau	YGB	1
batingo	Bny3	g
batio	BnzX	e
batri	BERM	x
batris	BQW2	6
baw	cVc	h
bawd	BXhO	h
bawdfedi	Bnz1	p
be	cV9	X
bechgyn	mvE	k
bechod	cWU	c
bedd	pCE	f
beddau	pBf	l
bedyddio	Bn0e	j
begian	Bn1B	d
beiau	mx1	h
beibl	BGBU	t
beibl	cWw	f
beiblau	BQ4D	z
beic	pDJ	f
beichiau	my6	o
beichio	Bn1e	b
beichiogi	Bn15	o
beichiogrwydd	cXP	w
beiciau	pCj	m
beicio	Bn2h	h
beiddio	Bn3C	f
beio	Bn3h	e
beirdd	m45	i
beirdd llawryfog	BTQ/	BH
beirniad	m99	r
beirniadaeth	m/g	z
beirniadaethau	m+o	4
beirniadol	cX/	k
beirniadu	Bn3/	s
beirniaid	m9N	w
beit	Bhf	f
beit	FGw	f
beitiau	OHK	m
beitiau	SFh	o
belg	BDfO	m
belled	BGWU	j
bendigedig	BVzG	7
bendigo	Bn4r	l
bendith	nBM	z
bendithio	Bn5Q	j
bendithion	nAT	5
benfro	BDf0	q
benthyca	Bn5z	e
benthyciad	nCv	o
benthyciadau	nB/	w
benthycio	Bn6R	p
benthycion	nDX	0
benthyg	Bjvx	g
benthyg	nEL	o
benyw	BGC3	d
benywaidd	BGDU	m
benyweta	Bn66	k
berf	Bis	e
berf anghyflawn	Bbqh	+
berf gyflawn	Bbrf	/
berfau	OIj	m
berfau anghyflawn	BgFG	BE
berfau cyflawn	BgGK	BB
berfenw	Bbpi	/
berfenwau	BgDx	BV
berwbwynt	BXhv	t
berwbwyntiau	BdYw	BE
berweddu	Bn7e	k
berwi	Bn8C	e
bet	BjK	b
beth	cYj	l
betiau	OJJ	q
betio	Bn8g	f
beunyddiol	cZI	q
bib	Bo3	e
bibiau	OPe	v
bidio	Bn8/	g
bidogi	Bn9f	k
bihafio	Bn+D	f
bil	nFc	i
biliau	nEz	p
bilio	Bn+i	b
biliwn	nGo	j
biliynau	nF+	q
biliynfed	BXic	l
bin	nHx	g
biniau	nHL	m
binomaidd	I64	o
bioamrywiaeth	cZy	x
biolegol	caj	r
biomeddygol	BFEC	4
bipiwr	BpV	m
bipwyr	OQN	1
bisg	I7g	b
bisged	BkJ	n
bisgedi	OKZ	o
bisgedi	OLB	r
bisgïen	Bkw	s
biwrocratiaeth	BGD6	x
blaen	nI4	g
blaenau	nIR	n
blaenbeipio	Bh4l	u
blaenbrofi	Bn+9	n
blaendal	BXjB	2
blaendaliad	BGEr	8
blaendaliadau	BQ42	BL
blaendalu	Bjd3	p
blaendalu	Bn/k	t
blaendarddu	BoAR	o
blaenddodi	BoA5	j
blaendir	Bmh	u
blaendiroedd	ONC	v
blaendorri	BoBc	s
blaengar	BCJZ	l
blaengaredd	BGFn	/
blaengynllunio	BoCI	u
blaenllaw	cbO	u
blaenllym	BPir	y
blaenllymu	BoC2	q
blaenlythrennau	YIf	BF
blaenlythyren	Ufj	BC
blaenol	XEC	1
blaenolwg	BZYA	t
blaenolygon	Beo+	/
blaenori	BoDg	p
blaenoriaeth	nKJ	s
blaenoriaethau	nJY	x
blaenoriaethol	BGGm	u
blaenoriaethu	BoEJ	1
blaenorol	cb8	p
blaenwerthu	BjWv	m
blaenwybodaeth	BGHU	6
blaenwybodaeth	BJJM	7
blaenyrru	Bh53	r
blaguro	BoE+	v
blas	+/7	s
blas	D2l	j
blasau	QvA	1
blasu	BoFt	j
blasuso	BoGQ	l
blawd	nLp	s
ble	ccl	f
blew	YJk	s
blewyn	Ugl	q
blewyn croes	Bn/	4
blewynnau croes	OOi	8
blingo	BoG1	q
blino	BoHf	g
bloc	nOH	j
blociau	nNg	n
blocio	BoH/	f
blodau	nM8	k
blodeuo	BoIe	j
blodiau	nK1	0
blodio	BoJB	i
blodyn	nMV	n
bloeddio	BoJj	g
bloesgi	BoKD	s
blonegu	BoKv	j
blotio	BoLS	e
blwch	nP2	o
blwch a blewyn	Wsk	BO
blwch anfon	DIW	x
blwch cyfunol	Cjo	7
blwch derbyn	DHj	z
blwydd	BVX0	5
blwyddi	BVYt	3
blwyddyn	BVZk	2
blwyddyn naid	BXj3	s
blychau	nPU	i
blychau anfon	P8X	y
blychau cyfunol	PSe	1
blychau derbyn	P7l	y
blynedd	/P8	z
blynyddoedd	nOq	q
blynyddoedd naid	BdZ0	/
blynyddol	cdE	n
blynyddoli	Bh6i	x
blysio	BoLw	h
blysu	BoMR	g
bob amser	BdBP	y
bochio	BoMx	j
bocs	nRC	e
bocsio	BoNU	c
bocsys	nQe	k
bod	BkEv	Z
bodd	cdr	i
boddhad	ceN	w
boddhaol	ce9	l
boddhau	BoNw	g
boddhaus	BGIO	1
boddi	BoOQ	c
boddloni	BoOs	i
boddro	BoPO	f
bodiau	BdX5	3
bodio	BoPt	f
bodlon	BGJD	v
bodloni	BoQM	h
bodolaeth	cfi	s
bodoli	BoQt	h
boglynnu	BoRO	i
bol	nSG	e
bola	nTK	e
bolaheulo	BoRw	k
bolheulo	BoSU	l
boliau	nRg	m
bolltio	BoS5	f
bolâu	nSk	m
bomio	BoTY	g
bonau	BP8i	y
bonau	nTo	m
bonclustio	BoT4	z
bond	BXlW	l
bondiau	Bdaz	p
bongamu	BoUr	k
bonheddig	cgO	s
bonion	nUt	k
bonws	nVR	g
bonysys	aqR	o
booleaidd	I94	n
border	BDpH	p
borderi	BP+W	y
bore	nWY	j
boreau	nVx	n
botwm	nXk	i
botwm adio	BXH8	x
botymau	nW7	p
botymu	BoVP	g
bowlio	BoVv	c
bownsio	BoWL	l
bracso	BoWw	m
bradfwriadu	BoXW	n
bradlofruddio	BoX9	s
bradu	BoYp	g
bradychu	BoZJ	g
braenaru	BoZp	r
braenu	BoaU	q
braf	cg6	g
bragaldio	Boa+	j
bragio	Bobh	e
bragu	Bob/	f
braich	nYu	h
braidd	cha	l
braint	Bre	o
brand	/h6	5
brandio	BjXV	o
brands	/hG	0
bras	BXl7	z
bras	ch/	Z
brasamcan	BXnf	7
brasamcanion	Bdbc	0
brasamcanu	BjwR	p
brasbwytho	Boc/	l
brasbwythu	Bodk	3
brasgamu	Boeb	j
brasio	Boe+	p
braslun	Bp7	m
brasluniau	ORC	s
braslunio	Bjw6	u
braslunio	Bofn	m
brasnaddu	BogN	p
braster	ciY	i
brasáu	Boce	h
brathu	Bog2	f
brawd	nZ6	k
brawddeg	nbL	n
brawddegau	nae	t
brawddegu	BohV	k
brawychu	Boh5	n
brechu	Boig	n
brecio	BojH	g
brecwast	ncn	u
brecwasta	Bojn	r
brecwastau	nby	1
breferu	BokS	i
brefu	Bok0	e
bregus	ci6	f
bregysu	BolS	h
breicheidio	Bolz	n
breichiau	nYG	o
breichiau ongl	BXoa	0
breichio	Boma	m
breinio	BonA	g
breintiau	OSk	z
breintiedig	I+f	x
breintio	Bong	k
breisgio	Booy	o
breisgáu	BooE	u
brenhinoedd	ndV	t
brenhinol	cjZ	h
brenin	neC	k
breuddwyd	nfa	o
breuddwydio	Bopa	l
breuddwydion	nem	0
breuhau	Bop/	r
breuo	Boqq	q
brewlan	BorU	l
bri	cj6	k
briciau	OTX	y
bricio	Bor5	l
bricsen	BsG	m
bridio	Bose	g
brifo	Bos+	c
brig	/jh	p
brigau	/iz	u
brigbori	Bota	h
brigdorri	Bot7	f
brigladd	Boua	r
brigo	BovF	e
britho	BhBd	s
britho	Bovj	j
brithwaith	BXpO	u
brithweithiau	BdcQ	9
brithweithio	Bjxo	x
briwio	BowG	j
briwlan	Bowp	j
briwlio	BoxM	g
briwo	Boxs	e
briwsioni	BoyK	n
bro	ngx	m
brochi	Boyx	d
brodio	BozO	j
brodorol	cke	q
brodyr	nZP	r
brolio	Bozx	d
bron	BXp8	g
bron	nh/	g
bron nad awn mor bell â dweud bod 	BPZj	Bx
bronnau	nhX	o
brown	clI	a
brudio	Bo0O	l
brwd	cli	d
brwdfrydedd	cl/	u
brwdfrydig	BGJy	s
brws	Bss	g
brwsiau	OUJ	r
brwsio	Bo0z	e
brwydr	njI	i
brwydrau	nif	p
brwydro	Bo1R	g
brwylio	Bo1x	f
brwyno	Bo2Q	h
brwysgio	Bo2x	g
brychu	BiRm	k
brychu	Bo3R	f
bryd	nkR	g
brydiau	njq	n
brydio	Bo3w	g
bryn	nlW	g
bryniau	nkx	l
brys	cmt	g
brysgerdded	Bo4Q	q
brysio	Bo46	h
bryste	BDge	l
bryweddu	Bo5b	e
bröydd	ngC	v
buan	cnN	h
buanedd	BWRC	x
buanedd cyfartalog	BXqc	BD
buarthu	Bo55	d
bucheddu	Bo6W	o
buchfrechu	Bo6+	m
buchod	nmY	g
budd	np7	n
budddal	BWRz	8
budddaliadau	nm4	7
buddddeiliad	BGKe	x
buddddeiliaid	BQ6B	3
buddiannau	nnz	q
buddiant	nod	y
buddio	Bo7k	j
buddiol	cnu	j
buddioli	Bo8H	i
buddion	npP	s
buddsoddi	Bo8p	m
buddsoddiad	nrW	t
buddsoddiadau	nqi	0
buddugoliaeth	BGLP	z
buddugoliaethau	BQ64	8
budr	Kqb	Z
budrelwa	Bo9P	q
budro	Bo95	e
budron	BCMH	d
bugeilio	Bo+X	m
bugunad	Bo+9	l
busnes	ns8	u
busnesa	Bo/i	i
busnesau	nsD	5
busnesu	BpAE	f
bustachu	BpAj	t
buwch	nl2	i
bwcio	BpBQ	g
bwgan	BGM3	z
bwganod	BQ8j	1
bwlch	Ui6	1
bwlch	nuS	h
bwlch didor	BtM	BB
bwldagu	BpBw	h
bwled	BuN	j
bwledi	OVv	o
bwletin	BGNq	l
bwletinau	BQ9Y	4
bwlio	BjTp	n
bwnglera	BpCR	k
bwrdd	nvZ	g
bwrdeistref	nwn	p
bwrdeistrefi	nv5	u
bwriad	nyH	v
bwriadau	nxQ	3
bwriadol	coR	l
bwriadu	BpC1	k
bwrlymu	BpDZ	f
bwrsariaeth	BGOP	r
bwrsariaethau	BQ+Q	/
bwrw	BpD4	i
bwrw	co2	l
bws	n8Q	f
bwthyn	nzf	l
bwthynnod	n0p	r
bwyd	n1U	i
bwydo	BpEa	e
bwydydd	n0E	l
bwyta	BpE4	f
bychain	BBmw	o
bychan	cpb	j
bychanu	BpFX	k
byclo	BpF7	c
byclu	BpGX	d
byd	n2g	e
byddar	cp+	b
byddaru	BpG0	e
byddin	n3p	h
byddino	BpHS	h
byddinoedd	n2+	r
byddwch yn gyson eich defnydd ohono	BboG	Bc
bydeang	cqZ	i
bydoedd	n12	q
bydwragedd	BQ/P	r
bydwraig	BGO6	q
bydwreigiaeth	BGPk	1
byffer	BgW	k
byfferi	OFz	r
bygwth	BpHz	g
bygwth	n46	l
bygylu	BpIT	f
bygythiad	n6P	p
bygythiadau	n5f	w
bygythio	BpIy	k
bygythion	n4K	w
bylbiau	BQ/6	n
bylchau	YMC	7
bylchau	ntq	o
bylchau didor	OU0	7
bylchu	BpJW	i
bylchwr	BXrf	BA
bylchwyr	BddN	BF
byngalo	BGRA	2
byngalos	BRAh	y
bynnag	cq7	d
byr	crY	h
byrbryd	BEyo	l
byrbrydiau	BQj8	3
byrbwylltra	BGR2	6
byrddau	nuz	m
byrddio	BpJ4	g
byrfodd	Bbtv	u
byrfoddau	BgHL	6
byrhau	BpKY	i
byrhoedlog	D6p	v
byrhoedlog	KsK	t
byrion	BGSw	l
byrlwybr	Bfr	r
byrlwybrau	OFD	w
byrlymu	BpK6	k
byrnio	BpLe	e
byrnu	BpL8	f
byrrach	Krq	g
byrraf	BXsf	m
byrrybudd	BGTV	u
byrstio	BpMb	f
bys	n7q	m
bysedd	n64	y
byseddu	BpM6	i
bysell	UUD	6
bysell adlam	r0	3
bysellau	X7m	BB
bysellau adlam	NJX	+
bysellfwrdd	UU9	5
bysellfwrdd	n98	r
bysellfyrdd	X8n	+
bysellfyrddau	n9Q	s
bysellu	BpNc	g
bysiau	ny2	p
bysio	BpN8	d
bysu	BpOZ	e
bysys	n8v	h
byth	cr5	e
bytheirio	BpO3	n
bytholi	BpPe	m
byw	csX	c
bywgraffyddol	BFIs	1
bywhau	BpQE	f
bywiocáu	BpQj	h
bywiog	csz	e
bywiogi	BpRE	m
bywiol	JBk	e
bywioldeb	HFT	u
bywluniad	Ujv	5
bywluniad	WAJ	2
bywluniadau	YM9	BG
bywluniadau	Zyd	BB
bywluniedig	XE3	z
bywlunio	BhDU	0
bywlunio	Bhdg	r
bywoliaeth	n/i	z
bywoliaethau	n+n	7
bywyd	oBF	o
bywydau	oAV	w
bôn	BDno	s
bôn	nUO	f
bỳlb	BGQZ	n
cablu	BpRq	j
caboli	BpSN	e
cachu	BpSr	f
caci	JAf	Z
cadair	oCX	j
cadarn	ctR	Z
cadarnach	BGW3	i
cadarnhad	Bwp	v
cadarnhad	ctq	v
cadarnhadau	OYv	z
cadarnhaol	cuZ	p
cadarnhau	BpTK	n
cadarnwedd	HCb	u
caddugo	BpTx	e
cadeiriau	oBt	q
cadeirio	BpUP	g
cadeirydd	oDr	s
cadeiryddion	oC6	x
cadw	BpUv	b
cadw deupen llinyn ynghyd	BMen	BL
cadwedig	BPfT	e
cadwedig	Xay	x
cadwmigei	BXtF	z
cadwraeth	BDhD	u
cadwyn	oFI	o
cadwynau	oEX	x
cadwyni	oFw	o
cadwyno	BpVK	h
cae	oG+	i
caeau	oGY	m
caeedig	BXt4	z
cael	Bj/M	e
cael	BkEY	X
cael gwared o	Bjga	u
cael hyd i	BOXf	w
caentach	BpVr	m
caerdydd	BFE6	l
caerfyrddin	BFFf	z
caernarfon	BFGS	r
caeth	cvC	g
caethgludo	BpWR	m
caethiwo	BpW3	j
caethwas	BwB	o
caethweision	OX/	w
caffi	oIF	g
caffis	oHg	l
cafflo	BpXa	f
cafnio	BpX5	g
cafnu	BpYZ	n
caglo	BpZA	i
caglu	BpZi	f
cais	B5J	h
cais	oJU	o
calchio	BpaB	d
calchu	Bpae	b
calcio	Bpa5	d
caled	cvi	k
caledu	BpbW	e
caledwedd	HGB	u
calendr	oKu	l
calendrau	oJ8	y
calibro	Bpb0	i
call	JCC	X
callaf	JCZ	k
called	BGUn	p
callineb	HGv	q
callio	BpcW	g
calon	oL9	j
calonnau	oLT	q
calonogi	Bpc2	j
calori	BxY	m
calorïau	OZi	z
cam	BpdZ	b
cam	oNF	e
camacennu	Bpd0	p
camamseru	Bped	i
camarfer	Bpe/	o
camarwain	Bpfn	e
camarweiniol	BFG9	w
camatal	BpgF	w
camau	oMg	l
camdaflu	Bpg1	q
camddarlunio	Bphf	s
camddeall	BpiL	r
camddealltwriaeth	BFHt	/
camddealltwriaethau	BQqt	/
camddefnyddio	Bpi2	l
camddehongli	Bpjb	s
camdeipio	BpkH	t
camdreiglo	Bpk0	p
camdreulio	Bpld	v
camdrin	BpmM	s
camdybio	Bpm4	m
camdyngu	Bpne	u
camdystiolaethu	BpoM	1
camenwi	BppB	h
camera	oOI	g
cameras	oNj	l
camerau	oOo	n
camfanteisio	BjS7	u
camfarnu	Bppi	l
camfeddwl	BpqH	q
camfesur	Bpqx	5
camffurfiedig	D+U	3
camffurfiedig	JC9	0
camffurfiedig	Kt+	0
camffurfio	Bh8b	p
camfihafio	Bprq	n
camfucheddu	BpsR	0
camgoelio	BptF	v
camgolledu	Bpt0	n
camgredu	Bpub	z
camgyfarwyddo	BpvO	w
camgyfrifo	Bpv+	u
camgyhuddo	Bpws	0
camgymeriad	oP8	s
camgymeriadau	oPP	t
camgymryd	Bpxg	n
camhysbysu	BpyH	v
camleoli	Bpy2	s
camliwio	Bpzi	x
camochri	Bp0T	p
camosod	Bp08	n
camp	BGXZ	v
campau	BRBT	9
campio	Bp1j	i
camplawn	BGY1	g
campwaith	BGYI	t
campweithiau	BRCQ	8
campws	oRf	t
campysys	oQo	3
camrifo	Bp2F	k
camsefyll	Bp2p	2
camsillafiad	Bzd	7
camsillafiadau	OcA	+
camsillafu	Bi46	z
camsillafu	Bp3f	o
camsynio	Bp4H	h
camu	Bp4o	d
camwahaniaethu	BjX9	4
camwario	Bp5F	n
camweddu	Bp5s	u
camymddwyn	Bp6a	o
camymddygiad	BGZV	z
camymddygiadau	BRDM	1
can	oSx	e
cancru	Bp7C	c
canddo	BGnS	i
caneuon	oTP	k
canfasio	Bp7e	j
canfed	BB2g	f
canfod	Bj/q	e
canfyddadwy	BGaI	q
canfyddedig	JEe	x
canfyddiad	BDkt	u
canfyddiadau	BDlb	t
canfyddydd	B0Y	t
canfyddyddion	Oc+	v
cangen	oU8	j
canghennau	oUP	t
canghennu	Bp8B	l
canhwyllau	BWLL	v
caniatadau	oVf	y
caniataol	D/L	q
caniataol	Kuy	s
caniataol	cwx	k
caniatáu	Bp8m	l
caniatâd	cwG	r
caniau	oSM	l
canllaw	oW+	y
canllawiau	oWR	t
canlyn	Bp9L	e
canlyniad	oYf	o
canlyniad ffafriol	BXur	8
canlyniadau	oXw	v
canlyniadau ffafriol	BdeS	BA
canlyniadol	JFP	x
canlynol	+5s	m
canlynol	JGA	m
canmol	Bp9p	j
canmoliaeth	BGay	3
canmoliaethau	BREB	z
cannoedd	oZ1	r
cannu	Bp+M	h
cannwyll	BV5J	l
canol	obD	m
canol dydd	BXvn	o
canol nos	BXwP	4
canol y cylchdro	BXxH	BA
canol y cymesuredd	BXyH	BK
canolau	oag	j
canolbarth	BGbp	7
canolbarthau	BRE0	z
canolbwynt	ocX	m
canolbwyntiau	obp	u
canolbwyntio	Bp+t	r
canoledig	B1F	v
canoledig	JGm	r
canolfan	odz	s
canolfannau	oc9	2
canoli	Bp/Y	i
canolig	cxV	g
canoloesol	cx1	s
canolog	cyh	j
canolradd	XFq	6
canolraddol	BGck	w
canolrif	Uln	6
canolrifau	YPI	BD
canoneiddio	Bp/6	l
canpwys	Umh	z
canpwysau	YQL	8
canradd	BXzR	y
canran	By2	n
canrannau	ObN	z
canrif	of9	p
canrifau	oef	x
canrifoedd	ofQ	t
canser	ohU	k
canserau	ogm	u
canslo	BqAf	d
canslo gwall	BX1D	BH
cant	oZH	u
canu	BqA8	k
canwaith	BdE8	2
canwyro	BqBg	f
canys	czE	n
capasiti	BGdU	s
capel	oig	j
capeli	oh4	o
capio	BqB/	k
capteiniaid	ojD	s
capten	okY	s
capteniaid	ojv	p
car	olp	e
carbon	czr	n
carboneiddio	BqCj	n
carchar	omu	h
carcharau	omH	n
carcharor	on+	o
carcharorion	onP	v
carcharu	BqDK	g
carcu	BqDq	i
cardfwrdd	BGeA	1
cardfyrddau	BRFn	1
cardiag	BEf9	r
cardiau	opQ	m
cardiau credyd	Bdk8	8
cardiolegol	BJMv	p
cardiolegydd	BGe1	1
cardiolegyddion	BRGc	BE
cardota	BqEM	b
caredig	BGfq	t
caredig	c0S	c
caredigion	BRHg	6
caredigrwydd	BV4d	s
caregu	BqEn	q
carfaglu	BqFR	i
carfan	BGgX	x
carfan	oqf	m
carfanau	op2	p
carfannau	BRIa	y
carfanu	BqFz	c
cariad	ort	i
cariadon	orF	o
cario	BqGP	d
cariwr	BGh4	k
carlamu	BqGs	i
carn	B10	f
carnau	M8m	n
caroli	BqHO	g
carpedu	BqHu	g
carpio	BqIO	b
carpu	BqIp	c
carreg	os4	i
cartesaidd	BYRC	l
cartesaidd	JHR	r
carth	BGkA	4
carthffosiaeth	BGic	+
carthion	BGja	m
carthion	BRJ4	BB
carthu	BqJF	h
cartio	BqJm	f
cartref	ouB	k
cartrefi	ota	n
cartrefu	BqKF	h
cartwnau	BRK5	y
cartŵn	BGk4	o
caru	BqKm	Z
carwyr	BRJM	s
cas	c0u	a
casetiau	BRLr	s
casgen	B2T	l
casgenni	Odt	1
casgliad	BX2K	Ba
casgliad	ovW	r
casgliadau	BdfS	BO
casgliadau	oul	x
casglu	BqLb	f
casglwr	BGmE	o
casglwyr	BRMX	q
castell	oxY	o
castelli	owB	v
castellu	BqL6	l
castio	BqMf	a
casáu	BqK/	c
casét	BGlg	k
catalog	oyt	n
catalogau	oyA	t
catalogio	BqM5	m
catalydd	BEby	r
catalyddion	BQYf	3
catalyddu	BjSL	w
categori	o0J	q
categorïau	ozU	1
cath	BHfb	i
cathod	BRsp	o
catrodi	BqNf	t
cau	BqOM	d
cawlio	BqOp	f
cawna	BqPI	r
cawodi	BqPz	h
caws	j9K	u
cebl	B24	f
cebl cyfechelog	B3X	BG
ceblau	Oei	v
ceblau cyechelog	OfR	6
cebystru	BqQU	d
cecian	BqQx	g
cecru	BqRR	d
cedenu	BqRu	k
ceffyl	o1k	q
ceffylau	o0z	x
cefn	o20	h
cefnau	o2O	m
cefndir	o4E	n
cefndiroedd	o3V	v
cefnogaeth	c1I	t
cefnogi	BqSS	k
cefnogol	c11	k
cefnogwr	o5f	r
cefnogwyr	o4r	0
cefnu	BqS2	o
ceg	o60	k
cega	BqTe	b
cegau	o6K	q
cegin	o8B	j
ceginau	o7Y	p
cegrythu	BqT5	g
cegu	BqUZ	f
cei	o9L	h
ceiau	o8k	n
ceibio	BqU4	c
ceidwad	o+X	k
ceidwadaid	o9s	r
ceincio	BqVU	j
ceinciog	Xs0	u
ceiniog	o/s	m
ceiniogau	o+7	x
ceintach	BqV3	m
ceir	olE	l
ceisiadau	Og3	9
ceisiadau	oIl	v
ceisiedig	JIl	s
ceisio	BjHT	i
ceisio	BqWd	d
ceisydd	BEcd	q
ceisyddion	BQZW	z
celc	B5q	f
celciau	Oh0	u
celciedig	H1b	o
celcio	BiSx	h
celcio	BqW6	h
celcu	BqXb	h
celf	pA8	j
celfau	pAS	q
celffeinio	BqX8	k
celfigion	pDo	r
celfigyn	pET	l
celfyddyd	pFm	q
celfyddyd er mwyn celfyddyd	BPEn	Bb
celfyddydau	pE4	u
celfyddydol	c2Z	u
cell	UKa	k
celloedd	M7s	6
celtaidd	BEdH	i
celu	BqYg	f
celwyddo	BqY/	e
cemegol	c3H	n
cenedl	pHE	p
cenedlaethau	pIi	w
cenedlaethol	c3u	w
cenedlaetholgar	BGhI	w
cenedlaetholi	BqZd	q
cenfigennu	BqaH	m
cenfigennus	BVaa	l
cenglu	Bqat	b
cenhadaeth	BEdp	+
cenhadu	BqbI	o
cenhedlaeth	pHt	1
cenhedloedd	pGQ	0
cenhedlu	BjQC	n
cenhedlu	Bqbw	t
cenhinen	BGms	m
cennin	BRNB	l
cennu	Bqcd	r
centigram	BX3k	q
centigramau	Bdgg	3
centilitr	BX4O	5
centilitrau	BdhX	v
centimetr	BX5H	z
centimetrau	BdiG	BD
cerbyd	pKD	y
cerbydau	pJS	x
cerdd	BPbU	BH
cerdd	pMB	k
cerddau	pK1	o
cerdded	BqdI	e
cerddetan	Bqdm	m
cerddi	BVNm	3
cerddi	pLd	k
cerddoriaeth	HHZ	y
cerddorol	c4e	n
cerddwr	pNN	k
cerddwyr	pMl	o
cerdyn	oom	q
cerdyn credyd	BX7c	2
ceredigion	BEen	o
cerfio	BqeM	h
cerflun	BEfP	u
cerfluniau	BQaJ	p
cerflunio	Bqet	h
cerhyntau	BSpJ	4
cernodio	BqfO	g
cerrig	osP	p
cerrynt	BJeD	6
ceryddu	Bqfu	i
cestyll	oww	o
cethru	BqgQ	f
cetris	OkM	z
cetrisen	B7y	u
ceugrwm	IBg	k
ceulo	Bqgv	n
chdi	BCMk	a
chi	BCM+	e
chwaer	pOc	m
chwaethu	BqhW	l
chwaith	c5F	s
chwalfa	B8g	j
chwalfeydd	Ok/	0
chwalpio	Bqh7	k
chwalu	Bqif	h
chwantu	BqjA	k
chwarae	BZoG	k
chwarae	Bqjk	g
chwaraeon	Be2x	o
chwaraewr	UoI	y
chwaraewr	pPu	n
chwaraewyr	YSF	3
chwaraewyr	pPC	s
chwaraeydd	UnU	0
chwaraeyddion	YRH	+
chwart	BYra	p
chwartau	BeK0	BF
chwarter	B9D	o
chwarter troad	Bckc	6
chwarterau	Olz	r
chwarterio	BqkE	k
chwarterol	c5x	q
chwarteru	Bqko	h
chwe	BW2W	p
chwech	BW2/	c
chweched	BW3b	l
chwedegau	BEgo	z
chwedl	pQ/	m
chwedlau	pQV	q
chwedleua	BqlJ	m
chwedloniaeth	BO9N	w
chwefror	BDSR	1
chweil	c6b	j
chwennych	Bqlv	i
chwenychu	BqmR	l
chwerthin	Bqm2	j
chwerthinllyd	BGn0	t
chwerw	c6+	i
chwerwi	BqnZ	q
chwi	BBnY	c
chwibanu	BqoD	j
chwibianu	Bqom	l
chwiblo	BqpL	l
chwidlo	Bqpw	j
chwifio	BqqT	f
chwildroad	pRl	u
chwildroadau	pUY	x
chwilfriwio	Bqqy	l
chwiliad	pS8	r
chwiliadau	pST	p
chwiliadwy	JJr	t
chwilio	BqrX	g
chwilmanta	Bqr3	j
chwilota	Bqsa	i
chwim	BGoh	d
chwimgysylltu	Bh9E	0
chwimio	Bqs8	k
chwincio	Bqtg	g
chwiorydd	pNx	r
chwipio	BquA	g
chwistrellu	Bqug	k
chwith	c7g	c
chwithig	Bc1u	j
chwithig	Bc2R	t
chwiwladrata	BqvE	l
chwyddhau	Bqvp	i
chwyddiant	c78	r
chwyddo	BhEI	k
chwyddo	BqwL	h
chwydu	Bqws	j
chwyldro	pTn	x
chwyldroi	CFp/	h
chwynnu	BqxP	k
chwyrlïo	Bqxz	j
chwyrn	BGqP	r
chwyrnellu	BqyW	i
chwyrnu	Bqy4	e
chwysigennu	BqzW	l
chwysu	Bqz7	k
chwythu	Bq0f	i
ci	pVr	p
cicio	Bq1B	c
ciciwr	B9r	l
cicwyr	Ome	p
cig	pW2	c
cigoedd	pWU	i
cigweinio	Bq1d	q
cigyddio	Bq2H	h
cilagor	Bq2o	j
cildremio	Bq3L	h
cildynnu	Bq3s	x
ciledrych	Bq4d	k
cilfach	Uko	/
cilfachau	YOD	BF
cilgnoi	Bq5B	n
cilgwthio	Bq5o	l
cilio	Bq6N	i
cilobeit	B+Q	u
cilobeitiau	OnH	w
cilogram	BVd7	m
cilogramau	BWAf	u
cilolitr	BaAr	y
cilolitrau	BfJK	7
cilometr	BaBd	y
cilometrau	BfKF	2
cilwenu	Bq6v	i
cilwgu	Bq7R	h
cilydd	EBq	l
cilyddion	Q5o	1
ciniawa	Bq7y	j
ciniawau	pX6	m
cinio	pXS	o
cip	ECP	e
cipedrych	Bq8V	g
cipiau	Q6d	m
cipio	Bq81	g
ciplun	B++	n
ciplunio	On3	q
cipolwg	B/l	p
cipolygon	Ooh	z
ciprys	Bq9V	i
ciropodydd	BGri	s
ciropodyddion	BRNm	0
cist	BGtf	p
cistiau	BRPE	u
ciw	CAO	d
ciwb	CAr	e
ciwbiau	Op8	t
ciwbig	JKY	f
ciwbio	BjyZ	n
ciwboid	BX8S	q
ciwboidau	Bdl4	y
ciwio	Bq93	e
ciws	OpU	o
claddu	Bq+V	g
claearu	Bq+1	o
claeru	Bq/d	o
claf	pZJ	n
clafeiddio	BrAF	i
clafychu	BrAn	j
clampio	BrBK	h
clandrio	BrBr	i
clapian	BrCN	p
clapio	BrC2	e
clasur	BGuI	o
clasurol	I1y	m
clasurol	c8n	j
clasuron	BRPy	p
clatsian	BrDU	i
clatsio	BrD2	g
clawdd	paa	j
clawr	pbm	i
clebran	BrEW	g
clecian	BrE2	j
cledru	BrFZ	d
clefyd	BGuw	j
clefyd	pcy	k
clefydau	pcI	q
clefydon	BRQb	2
clegru	BrF2	f
cleient	peE	n
cleientiaid	pdW	u
cleifion	pYg	p
cleilenwi	BrGV	n
cleio	BrG8	j
cleisio	BrHf	g
clem	Utt	q
clemiau	YYP	y
clemio	BrH/	f
clensio	BrIe	l
clepio	BrJD	f
clerc	pfY	l
clercio	BrJi	r
clercod	per	t
clero	BrKN	d
clewtio	BrKq	g
clic	CBJ	f
cliciau	Oqp	j
clicied	Ury	B7
cliciedau	YWM	CD
cliciedu	BrLK	u
clicio	BrL4	f
clinigol	c9K	l
clinigwr	BGvT	s
clinigwyr	BRRR	v
clinomedr	BX88	x
clinomedrau	Bdmq	3
clipfwrdd	CBo	u
clipfwrdd	EDz	u
clipfyrddau	OrM	v
clipfyrddau	Q8Y	0
clipio	BrMX	c
clir	c9v	g
cliriach	BGsO	i
clirio	BrMz	f
clirior arddangosydd	BX9t	BC
clo	CCW	d
cloc	pgk	g
cloc larwm	BX+v	6
cloch	CCz	g
clociau	pf9	n
clociau larwm	Bdnh	+
clocio	BrNS	i
clocsio	BrN0	h
clocwedd	BWSv	m
clod	c+P	p
cloddfa	BGv/	l
cloddfeydd	BRSA	p
cloddiau	pZw	q
cloddio	BrOV	e
cloddwr	BGsw	v
cloddwyr	BROa	q
clodfori	BrOz	i
cloeon	Or7	l
cloffi	BrPV	d
cloffrwymu	BrPy	k
cloi	CFoG	Y
clonau	OtL	m
cloncio	BrQW	h
clorian	BX/p	y
cloriannau	Bdof	/
cloriannu	BrQ3	m
cloriau	pa9	p
clos	BGwk	g
closio	BrRd	j
cludadwy	JK3	o
cludiad	VmE	y
cludiadau	ZXR	9
cludiant	c+4	o
cludo	BrSA	h
cludydd	UuX	2
cludyddion	YZB	+
clunhecio	BrSh	j
clunhercio	BrTE	s
cluro	BrTw	f
clust	phr	f
clustfain	BOxv	BD
clustfeinio	BrUP	q
clustiau	phE	n
clustnodi	BrU5	n
clwb	pix	f
clwcio	BrVg	j
clwstwr	CEa	o
clwydo	BrWD	f
clwyfo	BrWi	l
clybiau	piK	n
clybio	BrXH	i
clychau	Osg	r
clyfar	JLf	e
clymadwy	BCb6	u
clymau	BRV5	o
clymblaid	BJQh	4
clymbleidiau	BSi5	BA
clymedig	XCL	4
clymu	Bg+9	y
clymu	BrXp	b
clymwaith	BV++	o
clystyrau	OuX	q
clytio	BrYE	e
clyw	c/g	r
clywed	CFwH	d
clywedig	JL9	n
clôn	CDT	h
cnawd	dAL	m
cnawdoli	BrYi	k
cnecio	BrZG	c
cnecu	BrZi	a
cneifio	BrZ8	f
cneua	Brab	m
cneuo	BrbB	j
cnewyll	OvB	x
cnewyllyn	CFC	s
cnithio	Brbk	c
cnocellu	BrcA	h
cnocio	Brch	d
cnoi	CFoe	e
cnoi cil ar	BPMo	BK
cnuchio	Brc+	i
cnulio	Brdg	i
cnwd	pj1	f
cnydau	pjQ	l
cnydio	BreC	m
cobleru	Breo	g
coch	dAx	X
cochi	BrfI	g
cochli	Brfo	g
cocio	BrgI	c
coco	BEM9	m
cod	CFu	d
cod	pk3	e
codau	Ovy	n
codau	pkU	j
codi	Brgk	d
codi gwrychyn	BMfy	/
codiad	BEKl	6
codiad cyflog	BYAb	x
codiadau	BQTd	7
codiadau cyflog	Bdpe	1
codio	BrhB	b
codlo	Brhc	e
codymu	Brh6	e
coed	plV	i
coeden	pl3	g
coedio	BriY	s
coedwig	pnA	n
coedwigaeth	pnn	2
coedwigo	BrjE	h
coedwigoedd	pmX	p
coegi	Brjl	e
coegio	BrkD	f
coelcerth	BELf	x
coelcerth	BNDv	z
coelcerthi	BQUY	1
coelcerthi	BUcW	3
coelio	Brki	h
coethi	BiT4	e
coethi	BrlD	l
coetir	ppM	x
coetiroedd	pod	v
cof	pqs	j
cofarwydd	D4O	s
cofarwyddion	QxH	v
coffi	pr2	h
coffis	prP	n
cofftio	BrmO	h
coffáu	Brlo	m
cofiannau	Bf8b	x
cofiannu	Brmv	q
cofiant	BbXL	j
cofio	BrnZ	h
cofion	pp9	v
cofleidio	Brn6	f
cofnod	/k9	s
cofnod	CGL	l
cofnodi	BroZ	h
cofnodion	/kK	z
cofnodion	OwZ	q
cofrestr	ptD	o
cofrestrau	psX	s
cofrestredig	dBI	n
cofrestriad	puj	y
cofrestriadau	ptr	4
cofrestru	Bro6	m
cofrestrwr	pwQ	x
cofrestrwyr	pvV	7
cofrestrydd	px4	y
cofrestryddion	pxB	3
cofweini	Brpg	h
coginio	BrqB	j
cogio	Brqk	i
cogrdroi	BrrG	j
cola	BVfo	o
coladu	Brrp	k
colas	BWBN	s
colato	BrsN	k
colbio	Brsx	g
coleddu	BrtR	l
coleg	pze	r
colegau	pyq	0
colfachu	Brt2	j
coll	BYBM	0
coll	K0Q	Y
colled	p02	k
colledig	JMk	k
colledion	p0J	t
colledu	BruZ	g
collfarnu	Bru5	j
colli	Brvc	f
collnod	DR/	r
collnodau	QH4	x
colofn	p2H	l
colofnau	p1a	t
coluro	Brv7	j
colyn	CHm	i
colynnau	Oxz	s
colynnu	Brwe	i
comin	/mc	s
comins	/lp	z
comisiwn	p3d	r
comisiynau	p2s	x
comisiynu	BrxA	p
comisiynwr	BEJy	z
comisiynwyr	BQSn	2
compiwtereiddio	Brxp	s
compostio	BryV	m
conach	Bry7	i
conau	BWTV	r
concrit	HJM	p
concro	Brzd	n
condemnio	Br0E	y
confensiwn	BEMQ	t
confensiynau	BQVN	1
confensiynol	dBv	o
conffirmio	Br02	o
congl	CLt	i
conglau	O2j	z
conglfaen	BEBd	z
conglfeini	BQPZ	w
consortiwm	BEII	3
consortiymau	BQQx	8
consurio	Br1e	g
contract	p48	t
contractau	p4I	0
contractio	Br1+	l
contractiwr	BEI/	z
contractwr	p6c	u
contractwyr	BQRt	6
contractwyr	p5p	z
copa	BECQ	v
copa	CJn	g
copaon	BQQJ	o
copi	p71	l
copi proflennol	BMJE	7
copideipio	Br3E	q
copâu	O0K	v
copîau proflennol	BUA0	9
copïau	p7K	r
copïo	Br2j	h
corau	p8a	m
corcio	Br3u	i
cord	BYCA	w
corddi	Br4Q	i
cordeddiad	CKH	x
cordeddiadau	O05	2
cordeddu	Br4y	h
cordiau	BdqT	3
corfannu	Br5T	o
corff	p+m	i
corffau	p9g	l
corffoedd	p/I	l
corffoli	Br57	h
corfforaeth	CK4	1
corfforaethau	O1v	0
corfforaethol	dCX	1
corfforedig	BEEX	k
corffori	Br6c	h
corfforol	dDM	u
corganu	Br69	j
corlannu	Br7g	g
corn	qAM	k
cornel	UK+	t
corneli	O42	r
cornelu	Br8A	i
corni	Br8i	l
cornio	Br9H	f
coroni	Br9m	g
cosb	qBX	k
cosbau	qAw	n
cosbi	Br+G	g
cosi	Br+m	a
cosin	Uw1	y
cosinau	Ybz	5
cost	qCf	e
costau	qB7	k
costeffeithiol	BEE7	Bl
costeffeithlon	BJa9	/
costio	Br/A	d
costrelu	Br/d	i
cosyn	/n5	r
cosynnau	/nI	x
cownter	BYCw	n
cownteri	BdrK	z
cowntio	Br//	e
crabio	BsAd	i
crachennu	BsA/	p
cracio	BsBo	h
crafangu	BsCJ	h
craffu	BsCq	g
crafu	BsDK	h
cragen	qDi	h
crai	dD6	l
craidd	CMP	i
craidd	qKV	n
craig	qEr	l
cramennu	BsDr	i
crapio	BsEN	f
crasgnoi	BsEs	i
crasu	BsFO	d
crau	JNI	X
crawcio	BsFr	h
crawnio	BsGM	f
creadigol	dEf	n
creadigrwydd	BEGg	5
creadur	CMx	s
creaduriaid	O4I	u
crebachu	BsGr	l
crechwenu	BsHQ	j
crecio	BsHz	g
cred	qF6	i
credadwy	BEHZ	v
credau	qFQ	q
credu	BsIT	g
credyd	qHF	j
credydau	qGc	p
credydu	BsIz	k
crefft	qIX	q
crefftau	qHo	v
crefftwra	BsJX	w
creffynnu	BsKH	g
crefu	BsKn	f
crefydd	qJu	n
crefyddau	qJB	t
crefyddol	dFG	i
crefyddu	BsLG	k
cregyn	qC9	l
creiddiau	O3W	y
creiddiau	qK8	p
creiddio	BsLq	n
creigiau	qED	o
creinio	BsMR	j
creisioni	BsM0	p
creithio	BsNd	i
crensian	BsN/	k
crensio	BsOj	i
crestennu	BsPF	o
creu	BsPt	g
creuloni	BsQN	o
crewcian	BsQ1	h
crewtio	BsRW	j
cribddeilio	BsR5	i
cribinio	BsSb	j
cribo	BsS+	d
cric cymalau	jrN	w
crimpio	BsTb	g
crinellu	BsT7	w
crino	BsUr	i
crintachu	BsVN	q
crio	BsV3	b
cripian	BsWS	i
cripio	BsW0	e
crisialu	BsXS	r
critigol	JNf	o
criw	qMJ	l
criwiau	qLl	k
crochlefain	BsX9	j
crochweiddi	BsYg	j
croen	qQR	j
croeni	BsZD	d
croes	qNW	g
croesau	qMu	o
croesawu	BsaL	o
croesbostio	BhIP	3
croesddweud	BsZg	r
croesdoriad	BWUA	x
croesdoriadau	BWUx	3
croesdorri	CFvA	o
croesfertig	BYDX	9
croesgerhyntau	BSqB	BH
croesgerrynt	BJe9	+
croesgyfeirio	Bsaz	x
croeshoelio	Bsbk	m
croesholi	BscK	z
croesi	Bsc9	i
croeslin	BYEU	m
croesliniau	Bdr9	x
croeslinol	BYE6	i
croeso	HJ1	n
croestynnu	Bsdf	z
crog	BG2/	i
crogi	BseS	k
crom	BYFc	m
cromfach	Uyr	3
cromfachau	Yd4	9
cromfachog	JOH	t
cromlin	Uzi	t
cromlinau	Ye1	0
cron	BYHh	q
cronedig	JP6	n
cronellau	Bdtv	q
cronfa	qOf	i
cronfa ddata	BYGC	1
cronfeydd	qN2	p
cronfeydd data	Bdsu	BB
croniclo	Bse2	p
cronig	BG3h	r
cronnell	BYG3	q
cronni	Bsff	f
cronnus	JO0	l
cropian	Bsf+	l
cropio	Bsgj	e
crosio	BshB	j
croyw	dFo	l
cruglwytho	Bshk	q
crugo	BsiO	f
crwm	BYIL	h
crwn	BWVo	l
crwner	qPs	l
crwners	qPB	r
crwnio	Bsit	e
crwydro	BsjL	h
crwyn	qQ0	j
crybwyll	Bsjs	o
crychio	BskU	j
crychu	Bsk3	g
crydio	BslX	h
crydu	Bsl4	h
cryf	dGN	h
cryfach	BG4M	g
cryfaf	JPZ	h
cryfder	qSB	m
cryfderau	qRX	q
cryffáu	BsmZ	l
cryfhau	Bsm+	j
crygleisio	Bsnh	r
crygu	BsoM	k
crymanu	Bsow	o
crymu	BspY	e
cryn	K47	c
cryn	dGu	j
crynhau	Bsp2	t
crynhoi	CFo8	h
crynoddisg	U0P	1
crynoddisgiau	Yfp	/
crynodeb	qTX	p
crynodebau	qSn	w
crynodebu	Bsqj	l
crynodedig	XHq	4
crynoëdig	JQh	r
crynswth	BG5k	k
crynswth hanfodol	BG4s	4
crynu	BsrI	f
cryptograffeg	HKc	BA
crëydd	Uxn	BE
crëyddion	Ycs	BM
cuchio	Bsrn	d
cudd	dHR	a
cuddiedig	K4T	o
cuddio	BssE	e
cuddni	HLc	o
cufydd	BYIs	r
cufyddau	BduZ	t
cul	dHr	Z
culach	BYJX	j
culaf	BYJ6	e
culhau	Bssi	n
curo	BstJ	a
cusanu	Bstj	f
cw	/An	b
cwafftio	BsuC	i
cwango	BG6I	1
cwangos	BRVM	t
cwarel	U1E	u
cwareli	Ygo	0
cwart	CN3	g
cwartiau	O6N	p
cwato	Bsuk	c
cwbl	dIE	Z
cwblhad	VAX	9
cwblhadau	YsC	BD
cwblhau	BsvA	i
cwbwl	dId	Z
cwch	qUt	l
cwci	Blc	h
cwcis	OLs	p
cweryla	Bsvi	h
cwestio	BswD	s
cwestiwn	qV9	m
cwestiynau	qVS	r
cwestiynu	Bswv	i
cwffio	BsxR	f
cwis	qXO	j
cwisys	qWj	r
cwlio	Bsxw	h
cwlwm	BG69	k
cwm	/pb	v
cwmni	qYc	j
cwmnïau	qXx	r
cwmpas	BYKY	4
cwmpas	dI2	h
cwmpasau	BdvG	BF
cwmpasau	jln	w
cwmpasoedd	jmX	s
cwmpasu	BsyR	j
cwmpawd	BYLQ	w
cwmpawdau	BdwL	9
cwmwl	qav	h
cwndid	COX	m
cwndidau	O62	n
cwnnu	Bsy0	g
cwnsela	BjZa	o
cwota	C8E	h
cwota	CO9	h
cwotâu	O7d	n
cwotâu	PuQ	u
cwpan	qZn	h
cwpanaid	U1y	1
cwpanau	qY/	o
cwpaneidiau	Yhc	+
cwpanu	BszU	c
cwpelu	Bszw	e
cwpl	BG7h	i
cwpla	Bs0O	k
cwpláu	Bs0y	h
cwpon	CPe	j
cwponau	O8E	r
cwpwrdd	CQB	p
cwpwrdd cornel	CQq	BC
cwr	s0N	g
cwrdd	Bs1T	c
cwrdd	qcf	l
cwrian	Bs1v	f
cwricwlwm	qdy	q
cwricwlymau	qdE	u
cwrnad	Bs2O	a
cwrs	qfN	q
cwrt	BJYl	p
cwrw	sy1	n
cwsmer	qgk	k
cwsmerbenodol	BGo+	5
cwsmeriaid	qf3	t
cwta	JRM	Z
cwtanu	Bs2o	g
cwtogi	Bs3m	f
cwtáu	Bs3I	e
cwymplen	CRs	x
cwymplenni	O+Y	2
cwympo	Bs4F	c
cwyn	qh3	n
cwynau	qhI	v
cwynfan	Bs4h	i
cwynfanu	Bs5D	i
cwynion	qie	r
cwyno	Bs5l	j
cwyro	Bs6I	e
cyboli	Bs6m	m
cybyddu	Bs7M	h
cychio	Bs7t	h
cychod	qUA	t
cychu	Bs8O	g
cychwyn	BhHc	z
cychwyn	Bhe6	q
cychwyn	Bs8u	g
cychwyniad	WmE	BK
cychwyniadau	afy	BO
cychwynnol	BDhx	k
cycyllu	Bs9O	g
cyd	dJX	b
cyda	BByz	n
cyda	BGp3	Y
cydaddoli	BtC+	w
cydaddysgu	BtDu	v
cydadfer	BhJG	2
cydadferiad	U2n	9
cydadferiadau	Yia	BC
cydadrodd	BtEd	x
cydag	BGq6	o
cydamrywiad	HME	1
cydamseredig	IKL	2
cydamseriad	VyN	BA
cydamseriadau	Xyd	BE
cydamseru	BhhQ	w
cydariannu	BtFO	u
cydarwain	BtF8	u
cydateb	BtGq	s
cydawdur	BZ0W	p
cydawduron	BfBh	2
cydbenderfynu	BtHW	y
cydberthnasau	BRXR	BF
cydberthynas	BG8D	1
cydberthyniad	BG84	u
cydberthyniad	CSd	7
cydberthyniadau	BRYW	0
cydberthyniadau	O/O	BD
cydberthynol	BbcD	1
cydbwrcasu	BtII	z
cydbwyllgor	BG9m	8
cydbwyllgorau	BRZK	2
cydbwysedd	Wty	0
cydbwyso	BtI7	l
cydchwarae	BO+y	1
cydddefnyddio	Bs9u	w
cydddioddef	Bs+e	s
cydddisgybl	BG+i	7
cydddisgyblion	BRaA	1
cyddeimlo	Bs/K	n
cyddeithio	Bs/x	v
cyddestun	BG/d	x
cyddestun	qjz	r
cyddestunau	BRa1	6
cyddestunau	qjJ	q
cyddrefnu	BtAg	5
cyddyfu	BtBZ	y
cyddynnu	BtCL	z
cydeistedd	BtJg	p
cydfagu	BtKJ	z
cydfarnu	BtK8	y
cydfeddiannu	BtLu	z
cydfenthyg	BtMh	x
cydfentro	BHAO	0
cydffederasiwn	BHBC	/
cydffederasiynau	BRbv	BK
cydffurfio	BtNS	p
cydfodoli	BtN7	m
cydfonitro	BtOh	1
cydfwriadu	BtPW	w
cydfynd	BjaC	j
cydfyw	BtQG	q
cydgadeirydd	BHCB	0
cydgadeiryddion	BRc5	/
cydgadwyniad	EXz	7
cydgadwyniadau	RTe	4
cydgadwyno	BiXz	q
cydganlyn	BtQw	s
cydganu	BtRc	v
cydgasglu	BtSL	1
cydgefnogi	BtTA	s
cydgeisio	BtTs	n
cydgerdded	BtUT	o
cydgomisiynu	BtU7	2
cydgordio	BtVx	t
cydgroesi	BtWe	o
cydgrynhoi	BtXG	y
cydgyfeirio	BtX4	y
cydgyffwrdd	BtYq	r
cydgyfranogi	BtZV	w
cydgyllido	BtaF	z
cydgynllunio	Bta4	x
cydgynnull	Btbp	y
cydgysylltiedig	BHC1	7
cydgysylltu	Bjal	z
cydio	Btcb	p
cydladd	BtdE	p
cydlafurio	Btdt	2
cydlawenhau	Btej	z
cydleoli	BtfW	i
cydletya	Btf4	p
cydlifio	Btgh	x
cydlofnoda	BthS	t
cydlyniad	BPxB	+
cydlynol	dJy	i
cydlynu	Bth/	m
cydlynus	BHDw	u
cydlynwyr	qlY	2
cydlynydd	qke	6
cydnabod	BkAI	p
cydnabyddedig	dKU	o
cydnabyddiaeth	dK8	1
cydnaws	JSM	l
cydoesi	Btil	u
cydol	HaX	j
cydolygu	BtjT	r
cydorwedd	Btj+	s
cydosod	Bhkf	3
cydosod	Btkq	l
cydosodiad	VtL	/
cydosodiadau	ZfS	BH
cydosodydd	EYu	1
cydosodyddion	RUW	3
cydradd	CTY	k
cydradd	JRl	n
cydraddau	PAR	s
cydraddol	BtlP	n
cydraddoldeb	dLx	6
cydraddu	BhKx	8
cydran	qm+	s
cydraniad	U3k	7
cydraniadau	Yjc	BF
cydrannau	qmO	w
cydrannu	BhPR	+
cydrannu	Btl2	o
cydrannydd	VH9	7
cydranyddion	Y01	BC
cydredeg	Btme	n
cydroddi	BtnF	o
cydsefydlu	Btnt	0
cydsefyll	Btoh	r
cydseinio	BtpM	q
cydserennu	Btp2	o
cydsyniad	qoZ	o
cydsyniadau	qnq	v
cydsynio	Btqe	o
cyduno	BjbY	u
cyduno	BtrG	j
cydweddiad	U4f	BE
cydweddiadau	Ykh	BO
cydweddol	XJI	BC
cydweddu	BhJ8	1
cydweddu	Btrp	n
cydweithio	BtsQ	y
cydweithiwr	qp6	w
cydweithrediad	qrm	5
cydweithrediadau	qqq	8
cydweithredol	dMr	3
cydweithredu	BttC	s
cydweithwyr	qpB	5
cydweu	Bttu	l
cydymagweddu	BtuT	q
cydymddwyn	Btu9	r
cydymdeimlo	Btvo	0
cydymdrechu	Btwc	z
cydymffurfiad	D0N	5
cydymffurfiad	qtl	9
cydymffurfiadau	QsU	6
cydymffurfiadau	qsf	BG
cydymffurfiaeth	BHEe	BD
cydymffurfio	BiRC	k
cydymffurfio	BtxP	y
cydymffurfiol	JSx	z
cydymgynghori	BtyB	1
cydystyrio	Bty2	5
cyf	dNi	i
cyfaddas	JTk	n
cyfaddasu	Btzv	r
cyfaddawd	CT8	y
cyfaddawdu	Bt0a	w
cyfaddef	Bt1K	t
cyfaddefiad	BHFh	2
cyfaddefiadau	BRd4	BF
cyfaddodau	PA9	+
cyfaddodi	Bt13	u
cyfagos	dOE	v
cyfaill	/q/	q
cyfain	BCNc	g
cyfaint	BWWN	w
cyfalaf	/Qv	u
cyfamodi	Bt2l	r
cyfamser	qvd	y
cyfamserau	qui	7
cyfamseroedd	qwP	1
cyfamseru	Bt3Q	u
cyfan	CVY	h
cyfan	dOz	Z
cyfangu	Bhjp	2
cyfangu	Bt3+	n
cyfanhau	Bt4l	n
cyfanheddu	Bt5M	q
cyfannau	PB7	t
cyfannol	BHGX	y
cyfannu	Bt52	p
cyfanrif	CUu	q
cyfanrifau	M9N	u
cyfansawdd	BPkT	u
cyfansawdd	JUL	p
cyfansoddi	Bt6f	l
cyfansoddiad	qx5	6
cyfansoddiadau	qxE	1
cyfansoddiadol	BHHJ	3
cyfansoddydd	CV5	3
cyfansoddyddion	PCo	5
cyfanswm	qzr	v
cyfansymiau	qyz	4
cyfantoli	Bt7E	l
cyfanwaith	BOyy	0
cyfanwerthu	Bt7p	v
cyfanwerthwr	BHIA	x
cyfanwerthwyr	BRe9	+
cyfarch	BHIx	2
cyfarch	Bt8Y	g
cyfarchiad	CWw	t
cyfarchiad	CXd	v
cyfarchiadau	PDh	w
cyfarchiadau	PER	9
cyfarchion	BRf7	8
cyfarchu	Bt84	n
cyfarchydd	U5j	/
cyfarchyddion	Ylv	BL
cyfareddu	Bt9f	p
cyfarfod	q1O	q
cyfarfodwr	CYM	z
cyfarfodwyr	PFO	3
cyfarfodydd	q0a	0
cyfarpar	Bt+I	q
cyfarpar	dPM	v
cyfarparu	Bt+y	i
cyfartal	dP7	e
cyfartaledd	BWX3	5
cyfartaleddau	BYNA	u
cyfartalog	dQZ	l
cyfartalu	Bt/U	l
cyfarth	Bt/5	l
cyfarwain	BuAe	k
cyfarwydd	Xga	7
cyfarwydd	dQ+	k
cyfarwyddeb	Ea9	1
cyfarwyddebau	RWP	8
cyfarwyddiad	/rp	+
cyfarwyddiad	Eby	4
cyfarwyddiadau	RXL	+
cyfarwyddiadau	q14	8
cyfarwyddiaeth	BHJn	4
cyfarwyddo	BuBC	o
cyfarwyddwr	q3k	6
cyfarwyddwragedd	BRg3	BF
cyfarwyddwraig	BHKf	y
cyfarwyddwyr	q20	w
cyfarwyddyd	q5Z	3
cyfarwyddydau	q4e	7
cyfatal	BuBq	m
cyfateb	BuCQ	n
cyfatebiaeth	VuK	BM
cyfatebiaethau	ZgZ	BT
cyfatebol	dRi	w
cyfatebu	BuC3	r
cyfath	BYNu	h
cyfathiannau	BdxI	0
cyfathiant	BYOP	u
cyfathrach	BuDi	n
cyfathrachu	BuEJ	h
cyfathrebiad	CY/	7
cyfathrebiad	Ecq	7
cyfathrebiadau	PGF	/
cyfathrebiadau	RYJ	BB
cyfathrebiaeth	U6i	BM
cyfathrebu	BuEq	p
cyfebru	BuFT	o
cyfebu	BuF7	m
cyfeddach	BuGh	q
cyfeilio	BuHL	s
cyfeiliorni	BuH3	l
cyfeillacha	BuIc	u
cyfeillgar	dSS	o
cyfeillgarwch	BHLR	+
cyfeillion	/qK	1
cyfeintiau	BWW9	6
cyfeiriad	Ccm	v
cyfeiriad	q7I	x
cyfeiriad ip sefydlog	BW0	Bd
cyfeiriadaeth	Wum	BJ
cyfeiriadau	PKB	6
cyfeiriadau	q6Q	4
cyfeiriadau ip sefydlog	N6c	Ba
cyfeiriadur	CZ6	5
cyfeiriaduron	PHE	6
cyfeiriannau	Bdx8	8
cyfeiriannu	BuJK	q
cyfeiriant	BYO9	BF
cyfeirio	BuJ0	l
cyfeiriol	J1j	s
cyfeirlyfr	BHMP	5
cyfeirlyfrau	BRh8	9
cyfeirnod	U8t	BA
cyfeirnod	q8z	v
cyfeirnod grid	BYQC	BA
cyfeirnodau	YoG	/
cyfeirnodau	q75	6
cyfeirnodau grid	Bdy4	9
cyfeirnodi	BuKZ	w
cyfeirydd	U7u	/
cyfeiryddion	Ym6	BM
cyfenwadur	Caz	/
cyfenwaduron	PH+	BG
cyfenwi	BuLJ	o
cyfer	dS6	i
cyferbyn	JU0	m
cyferbyniad	Cby	0
cyferbyniadau	PJE	9
cyferbynnu	BuLx	u
cyferbynnu	BuMf	p
cyfernod	CdV	v
cyfernodau	PK7	9
cyfesuryn	VvW	7
cyfesurynnau	Zhs	BE
cyfetholi	BuNI	s
cyffeithio	BuN0	l
cyffelyb	dTc	o
cyffelybu	BuOZ	r
cyffesu	BuPE	p
cyffin	BHNI	1
cyffiniau	BRi5	4
cyffio	BuPt	s
cyffredin	dUo	k
cyffredinol	dUE	k
cyffredinoli	BuQZ	u
cyffredinoliad	Cft	BA
cyffredinoliadau	PNr	BG
cyffro	Cgt	o
cyffroau	POx	7
cyffroi	BuRH	m
cyffrous	dVM	s
cyffur	q+V	p
cyffuriau	q9i	z
cyffwrdd	BuRt	i
cyfiau	Wvv	2
cyfiau cymhlyg	HM5	BF
cyfiawnadau	q/z	x
cyfiawnder	rBT	1
cyfiawnderau	rAk	v
cyfiawnhad	q++	1
cyfiawnhau	BuSP	j
cyfieithiad	rDE	0
cyfieithiadau	rCI	8
cyfieithiedig	JWQ	4
cyfieithu	BuSy	v
cyfieithwyr	rD4	9
cyfieithydd	rE1	0
cyfieithyddion	rFp	5
cyfieuo	BuTh	f
cyflafareddu	BuUA	m
cyflawn	dV4	m
cyflawni	BuUm	q
cyflawni hunanladdiad	BMgx	BZ
cyflawniad	rHa	7
cyflawniadau	rGi	4
cyflawnrwydd	BHN9	3
cyfle	rLl	t
cyflegru	BuVQ	n
cyflenwad	dWe	q
cyflenwadau	rJQ	w
cyflenwi	BuV3	k
cyflenwol	JXI	t
cyflenwr	rKx	0
cyflenwyr	rKA	x
cyfleoedd	rIV	7
cyfleon	rMS	w
cyfleu	BuWb	o
cyfleus	dXI	l
cyfleuster	rNy	x
cyfleusterau	rNC	w
cyfliwio	BuXD	i
cyflog	rPU	q
cyflog sylfaenol	BYRn	5
cyflogaeth	dXt	w
cyflogai	BHO0	o
cyflogau	rOj	x
cyflogau sylfaenol	Bdz1	7
cyflogedig	jnD	q
cyflogeion	BRjx	v
cyflogi	BuXl	k
cyflogwr	rQu	q
cyflogwyr	rP+	w
cyfloi	BuYJ	m
cyflun	BYSg	w
cyflunedd	BYTQ	BG
cyfluneddau	Bd0w	BD
cyflunio	BuYv	l
cyflwr	rSJ	r
cyflwyniad	rTp	v
cyflwyniadau	rS0	1
cyflwyniadol	LFo	1
cyflwynlyfr	BOqV	2
cyflwynlyfrau	BVFa	BB
cyflwyno	BuZU	n
cyflym	dYd	f
cyflymach	IHn	k
cyflymaf	BYUW	n
cyflymder	BWYw	k
cyflymder	BYU9	BF
cyflymderau	BWZU	r
cyflymderau	Bd1z	BC
cyflymiad	ChV	x
cyflymiadau	PPs	BE
cyflymu	BuZ7	o
cyflymydd	/o	x
cyflymyddion	Ngu	5
cyflynu	Buaj	h
cyflyrau	rRY	x
cyflyru	BubE	o
cyfnerthu	Bubs	o
cyfnewid	BucU	l
cyfnewidfa	/th	8
cyfnewidfaoedd	/sn	6
cyfnewidfeydd	/ud	BI
cyfnewidfâu	rUY	6
cyfnewidiol	BHPc	t
cyfnod	rV+	x
cyfnod gwirio	BDtb	BE
cyfnodau	rVS	s
cyfnodau gwirio	BQBw	BG
cyfnodol	JX1	n
cyfnodolion	BRkg	BD
cyfnodolyn	BHQJ	y
cyfochrog	JYc	p
cyfodi	Buc5	f
cyfodli	BudY	m
cyfoed	BHQ7	1
cyfoedi	Bud+	1
cyfoedion	BRlj	7
cyfoes	dY8	n
cyfoesi	Buez	0
cyfoeth	dZj	m
cyfoethog	daJ	k
cyfoethogi	Bufn	l
cyfogi	BugM	g
cyfori	Bugs	h
cyfosod	BuhN	m
cyfradd	rXa	k
cyfradd cyfnewid	BYWC	2
cyfradd llog	BYW4	4
cyfraddau	rWv	r
cyfraddau cyfnewid	Bd21	BO
cyfraddau llog	Bd4D	BK
cyfraith	rZU	r
cyfran	raw	o
cyfranddaliad	/wj	BA
cyfranddaliadau	/vl	+
cyfraniad	rcM	t
cyfraniadau	rbY	0
cyfrannau	rZ/	x
cyfrannog	rek	3
cyfrannol	IY0	r
cyfrannu	Buhz	w
cyfrannwr	CiG	w
cyfranogi	Buij	t
cyfranogiad	dat	z
cyfranogion	rc5	6
cyfranogwyr	rdz	x
cyfranwyr	PQw	x
cyfrddwyn	BujQ	s
cyfrdroi	Buj8	l
cyfredeg	Bukh	r
cyfredol	dbg	o
cyfreithiau	rX+	u
cyfreithio	BulM	t
cyfreithiol	dcI	s
cyfreithion	rYs	o
cyfreithiwr	rgQ	u
cyfreithloni	Bul5	q
cyfreithwyr	rfb	1
cyfres	/xj	7
cyfresau	BBn0	s
cyfresi	BBog	o
cyfresol	M4Y	v
cyfresoli	BjY1	l
cyfresoliad	BKFS	y
cyfresoliadau	BTAI	5
cyfresymu	Bumj	o
cyfrif	BDqL	v
cyfrif	BunL	j
cyfrif	rhu	t
cyfrif cyfredol	BYXw	5
cyfrif cynilo	BYYp	5
cyfrifau	rg+	w
cyfrifeg	Wwl	BG
cyfrifiad	BYZi	2
cyfrifiad	rj4	x
cyfrifiadau	Bd7S	BA
cyfrifiadau	rjI	w
cyfrifiadur	rlj	w
cyfrifiadureg	Bc8I	8
cyfrifiaduro	Bunu	w
cyfrifiadurol	dc0	s
cyfrifiaduron	rkp	6
cyfrifianellau	BVSj	+
cyfrifiannell	BP2u	u
cyfrifiannu	Buoe	w
cyfriflen	BYaY	6
cyfriflenni	Bd8S	BD
cyfrifo	BupO	m
cyfrifol	rmT	z
cyfrifoldeb	rnG	9
cyfrifoldebau	roD	6
cyfrifon	BP/I	z
cyfrifon	rib	t
cyfrifon cyfredol	Bd5N	BE
cyfrifon cynilo	Bd6R	BB
cyfrifyddol	XKK	/
cyfrinach	rqr	y
cyfrinachau	ro9	0
cyfrinachedd	ddg	7
cyfrinachoedd	rpx	6
cyfrinachol	deb	3
cyfrinachon	rrd	4
cyfrinair	rtG	0
cyfrineiriau	rsV	x
cyfrinymadrodd	C9O	9
cyfrinymadroddion	Pvv	4
cyfro	Bup0	d
cyfrodeddu	BuqR	w
cyfrol	/zX	t
cyfrolau	/ye	5
cyfrwng	rus	r
cyfrwyo	BurB	o
cyfryngau	rt6	y
cyfryngu	Burp	n
cyfryw	dfS	o
cyfseriad	Ci2	y
cyfseriadau	PRh	9
cyfun	rwH	f
cyfundrefn	rwm	z
cyfundrefn ffeiliau	BUK	BI
cyfundrefnau	rvX	w
cyfundrefnau ffeiliau	N4o	8
cyfundrefnu	BusQ	o
cyfuniad	ryH	x
cyfuniadau	rxZ	u
cyfuno	BjC9	s
cyfuno	Bus4	p
cyfunol	JZF	m
cyfunol	JZr	n
cyfweld	Buth	l
cyfweliad	rzw	v
cyfweliadau	ry4	4
cyfwerth	df6	v
cyfwng	U+g	8
cyfwng dosbarth	BYbS	BN
cyfyng	dgp	h
cyfyngau	Yp/	BF
cyfyngau dosbarth	Bd9V	BU
cyfyngedig	dhK	m
cyfyngiad	/Bi	o
cyfyngiad	BHRw	1
cyfyngiadau	/CK	0
cyfyngiadau	BRme	0
cyfyngu	BuuG	i
cyfystyr	Ckj	r
cyfystyr	JaS	o
cyfystyron	PTT	2
cyhoedd	dhw	m
cyhoeddedig	diW	x
cyhoeddi	Buuo	r
cyhoeddiad	r1b	x
cyhoeddiadau	r0f	8
cyhoeddus	djH	k
cyhoeddusrwydd	djr	8
cyhoeddwr	r2M	4
cyhoeddwyr	r3E	y
cyhuddiad	r4q	y
cyhuddiadau	r32	0
cyhuddo	BuvT	j
cyhwfan	Buv2	i
cyhyd	dkn	k
cyhydeddu	BuwY	s
cyhyr	BdJw	i
cyhyrau	Bg2U	3
cyhyrog	BdKS	o
cylch	r7E	q
cylch bywyd	BEzN	v
cylch bywyd	BH6f	v
cylch cythreulig	BH12	4
cylch docyn	HUk	1
cylcharwain	BuxE	s
cylchau bywyd	BQkz	BC
cylchdro	Cl3	q
cylchdroeon	PVA	1
cylchdroi	CFpd	i
cylchedd	BYfB	BE
cylcheddau	BeBj	BK
cylchfa	VBU	y
cylchfan	BGxx	w
cylchfan	VCG	3
cylchfannau	BRSp	6
cylchfannau	YuA	BB
cylchfaoedd	YtF	7
cylchgrawn	r6U	w
cylchgronau	r5c	4
cylchlythyr	/1B	3
cylchlythyrau	/0E	9
cylchlythyru	Buxw	u
cylchoedd	r7u	t
cylchoedd bywyd	BR95	4
cylchoedd cythreulig	BR6v	BM
cylchol	J9p	j
cylchol	XLJ	y
cylchred	U/c	7
cylchredau	YrE	+
cylchredeg	Buye	n
cylchrediad	Cmh	0
cylchrediadau	PV1	7
cylchredol	Ja6	t
cylchu	BhiA	z
cylchu	BuzF	n
cylchwedd	HN+	u
cylchyn	BYgF	5
cylchynnau	BeCt	BB
cylchynu	Buzs	n
cyllellu	Bu0T	o
cyllid	BYg+	p
cyllid	r8b	j
cyllidau	BeDu	t
cyllidau	r9r	p
cyllideb	r+U	w
cyllidebau	r8+	t
cyllidebol	BHSl	n
cyllido	Bu07	n
cyllidol	Jbn	o
cymaint	dlL	u
cymal	r/v	o
cymal	sA+	h
cymalau	r/E	r
cymalau	sAX	n
cymanwlad	CnV	z
cymanwledydd	PWw	4
cymar	BCN8	k
cymaradwy	BHTM	p
cymarebau	PYn	z
cymaresau	BCPA	r
cymariaethau	sCO	t
cymaryddion	BRnS	5
cymathu	Bu1i	j
cymdeithas	sDv	0
cymdeithas adeiladu	BYhn	BK
cymdeithasau	sC7	0
cymdeithasau adeiladu	BeEb	BP
cymdeithaseg	Bc4V	x
cymdeithasol	dl5	k
cymdeithasu	Bu2F	p
cymdogaeth	CoI	4
cymdogaethau	PXo	/
cymdogion	sFZ	x
cymedr	VC9	w
cymedrau	YvB	8
cymedrig	XL7	2
cymedrol	XNm	z
cymedroledig	XMx	1
cymedroli	Bu2u	n
cymedrolwr	Eek	z
cymedrolwyr	RaR	7
cymell	BHWH	s
cymell	Bu3V	g
cymelliadau	BRoL	3
cymeradwy	dmd	n
cymeradwyaeth	dnE	7
cymeradwyo	Bu31	o
cymeriad	sG6	w
cymeriadau	sGK	w
cymeryd	Bu4d	q
cymesur	BHUq	u
cymesur	BWZ/	r
cymesuredd	BYjZ	r
cymesuredd adlewyrchiad	BYkE	BD
cymesuredd cylchdro	BYlH	BX
cymesureddau	BeFq	0
cymesureddau adlewyrchiad	BeGe	BL
cymesureddau cylchdro	BeHp	BH
cymesurol	BYix	o
cymhareb	CpA	o
cymhares	BCPr	o
cymhariaeth	sBf	v
cymharol	dn/	v
cymharu	Bu5H	o
cymharydd	BHT1	1
cymharydd	Cpo	v
cymharyddion	PZa	8
cymheiriaid	BCQT	2
cymhelliad	BHVY	v
cymhelliannau	sIi	z
cymhelliant	sHq	4
cymhellion	BRpC	z
cymhennu	Bu5v	f
cymhleth	BBar	x
cymhlethdod	BHWz	y
cymhlethu	Bu6O	u
cymhlyg	W/w	r
cymhlygion	Ziw	BG
cymhlygyn	VwR	BB
cymhorthdal	BHXl	r
cymhorthdal	sKK	1
cymhwysedd	sL7	y
cymhwysiad	VDt	6
cymhwyso	BjzA	l
cymhwyso	Bu68	i
cymhwyster	sNp	1
cymodi	Bu7e	j
cymoedd	/ok	3
cymoni	Bu8B	h
cymorth	dou	w
cymorthdaliadau	BRp1	8
cymorthdaloedd	sJV	1
cymortháu	Bu8i	o
cymowta	Bu9K	m
cymraeg	BHYQ	3
cymraeg	BHat	s
cymraes	BHZH	1
cymreictod	BHbZ	v
cymreig	BHZ8	x
cymreigio	Bu9w	n
cymro	BVgQ	7
cymrodeddu	Bu+X	n
cymru	BGyh	z
cymrugyfan	BGzU	n
cymry	BWB5	x
cymryd	Bu++	h
cymryd ar	Bc5G	m
cymryd yn ganiataol	BdAC	BN
cymudo	Bu/f	k
cymuned	sPU	u
cymunedau	sOe	2
cymunedol	dpe	n
cymuno	BvAD	q
cymwys	/Rd	q
cymwyseddau	sK/	8
cymwysedig	dqF	n
cymwysiadau	Yv9	BA
cymwysterau	sMt	8
cymydog	sEj	2
cymylau	qaI	n
cymylu	BvAt	s
cymynnu	BvBZ	i
cymynroddi	BvB7	o
cymynu	BvCj	g
cymysg	dqs	m
cymysgedd	sQ3	u
cymysgeddau	sQC	1
cymysglyd	Jg7	o
cymysgu	BvDD	e
cymysgydd	CqX	s
cymysgyddion	PaW	y
cyn	BCAz	l
cyn	drS	m
cyn belled ag y bon ymarferol	BMEr	BL
cynadledda	BvEO	4
cynadleddau	sSd	0
cynadleddu	BvFG	k
cynaeafu	BvFq	l
cynaladwy	BGz7	m
cynaliadwy	dr4	p
cynaliadwyedd	BHqL	1
cynaliedig	XOZ	BB
cynanu	BvGP	r
cynddeiriogi	BvG6	s
cyndynnu	BvHm	x
cyndynrwydd	BHrA	BG
cyneddfu	BvIX	z
cynefin	sUB	w
cynefino	BvJK	s
cynefinoedd	sTR	w
cynenedigol	BHsG	w
cynfas	CrD	k
cynfasau	PbI	y
cynffon	EfX	k
cynffonna	BvJ2	u
cynffonnau	RbM	2
cynfyfyriwr	BHs2	5
cynfyfyrwyr	BRzf	9
cynganeddu	BvKk	t
cyngerdd	sVp	s
cyngherddau	sUx	4
cynghorau	sXB	s
cynghori	BvLR	l
cynghorol	BHcI	n
cynghorwr	sXt	s
cynghorwyr	sYZ	y
cynghorydd	saA	y
cynghoryddion	sZL	1
cynghoryn	ClO	p
cynghraffu	BvL2	q
cynghrair	BHcv	x
cynghrair	BHdg	2
cynghreiriau	BRqx	3
cynghreiriau	BRro	BB
cynghreirio	BvMg	k
cyngofrestru	BvDh	t
cyngor	sWV	s
cyngorynnau	PUJ	3
cynhadledd	sRl	4
cynhaliaeth	dsh	n
cynhaliwr	sbp	w
cynhalwyr	say	3
cynharach	dtI	s
cynharaf	dt0	p
cynheica	BvNE	t
cynhenid	dud	i
cynhenna	BvNx	l
cynhennu	BvOW	o
cynhesach	BYme	r
cynhesaf	BYnJ	s
cynhesrwydd	BV5u	n
cynhesu	BvO+	l
cynhinio	BvPj	i
cynhwynol	LGd	o
cynhwysedd	BYn1	BH
cynhwysfawr	du/	s
cynhwysiad	Crn	w
cynhwysiad	VxS	7
cynhwysion	sdD	u
cynhwysol	Jhj	p
cynhwysydd	CsX	x
cynhyrchiad	sej	z
cynhyrchiadau	sdx	y
cynhyrchiant	/SH	6
cynhyrchiol	BOvh	l
cynhyrchion	sgK	w
cynhyrchu	BvQF	l
cynhyrchwr	sg6	s
cynhyrchwyr	svg	y
cynhyrchydd	sup	3
cynhyrfu	BvQq	l
cynhyrfus	LHF	o
cynifer	dvr	k
cynigio	BvRP	i
cynigion	BR1a	s
cynigion	siP	r
cynilo	BvRx	h
cynio	BvSS	g
cyniwair	BvSy	m
cyniweirio	BvTY	p
cynllun	sjj	p
cynllun gweithredu	BMn0	BB
cynlluniau	si6	p
cynlluniau gweithredu	BUPb	BI
cynllunio	BvUB	i
cynllwynio	BvUj	i
cynllyfanu	BvVF	l
cynlywydd	BHtv	/
cynlywyddion	BR0c	+
cynnal	BvVq	p
cynnal a chadw	BJyK	BB
cynnal arolwg	BXX7	3
cynnar	dwP	k
cynnau	BvWT	k
cynnes	dwz	g
cynnig	BHuu	u
cynnig	BvW3	j
cynnig	shm	p
cynnig a chynnig	BYo8	BI
cynnu	BvXa	k
cynnull	BvX+	f
cynnwys	BvYd	h
cynnwys	scZ	q
cynnydd	BYqE	r
cynnydd	dxT	n
cynnyrch	sfW	0
cynorthwyo	BvY+	l
cynorthwyol	Jew	w
cynorthwyol	Jfg	t
cynorthwyol	JgN	u
cynorthwyol	dx6	n
cynorthwyydd	BHvc	y
cynorthwyyddion	BR2G	BE
cynradd	dyh	i
cynraddedig	BHzj	z
cynrhoni	BvZj	n
cynrychiadol	BFno	z
cynrychiolaeth	slL	2
cynrychiolaethau	skM	/
cynrychioli	BvaK	o
cynrychioliad	Ef7	9
cynrychioliadau	RcC	BA
cynrychioliadol	BFob	BD
cynrychiolwr	snF	/
cynrychiolwyr	smB	BE
cynrychiolydd	spG	9
cynrychiolyddion	soE	BC
cynsail	BH0W	x
cynseiliau	BR5D	y
cynt	dzD	n
cynta	BW1X	/
cyntaf	BW0k	z
cynted	BCRJ	k
cynulleidfa	srC	2
cynulleidfaoedd	sqD	/
cynulleidfeydd	sr4	BC
cynulliad	stx	4
cynulliadau	ss6	3
cynuta	Bvay	l
cynweinidog	BHnH	3
cynwyseddau	BeIw	BO
cynwysiadau	Pb6	5
cynwysiadau	Zj2	/
cynwysyddion	Pcz	0
cynyddol	dzq	l
cynyddu	BvbX	q
cynyrchyddion	swS	0
cynysgaeddu	BvcB	m
cyplau	BRWh	w
cyplu	Bvcn	m
cyplysu	BvdN	g
cypyrddau	O8v	u
cypyrddau cornel	O9d	7
cyraeddadwy	LHt	0
cyraeddiadau	sx6	7
cyrchadwy	JeF	r
cyrchfan	CtI	t
cyrchfannau	Pdn	8
cyrchiad	zs	n
cyrchiadau	NSO	8
cyrchnod	VEn	4
cyrchnodau	Yw9	+
cyrchu	Bhrw	m
cyrchu	Bvdt	j
cyrchydd	0T	o
cyrchyddion	NTK	4
cyrcydu	BveQ	q
cyrddau	qb4	n
cyrfau	szc	x
cyrff	p+F	h
cyrhaeddiad	sxG	0
cyrhaeddwragedd	BRyg	/
cyrhaeddwraig	BHpZ	y
cyriau	s0t	m
cyrion	s1T	i
cyrn	p/t	f
cyrnio	Bve6	f
cyrraedd	Bg70	t
cyrraedd	BvfZ	j
cyrrau	qbQ	o
cyrsiau	qec	x
cyrtiau	BSln	y
cyrydu	Bvf8	f
cysawd	CvC	BG
cysawd gweithredu	Ct1	BN
cysawdau	Pfq	BN
cysawdau gweithredu	Pej	BH
cysefin	XPa	v
cysegru	Bvgb	m
cyseilio	BvhB	k
cyseinedd	BOsE	0
cyseinio	Bvhl	o
cysgod	s2e	l
cysgodi	BviN	i
cysgodion	s11	p
cysgu	Bviv	g
cysidro	BvjP	m
cysodi	Bvj1	k
cyson	XhV	5
cyson	d0P	d
cysondeb	d0s	v
cysoni	Bhgg	w
cysoni	Biad	l
cysoni	BvkZ	m
cysoniad	VzN	8
cysoniadau	Zk1	BB
cysonion	BeJ+	2
cysonyn	BYqv	r
cystadlaethau	s36	z
cystadleuaeth	s3D	3
cystadleuol	d1b	o
cystadleuwr	s5p	5
cystadleuwyr	s4t	8
cystadlu	Bvk/	i
cystal	d2D	j
cystrawen	CwI	s
cystrawennau	Pg3	BD
cystuddio	Bvlh	h
cystwyo	BvmC	k
cysur	s7U	u
cysurau	s6i	y
cysuro	Bvmm	h
cysuron	s8C	s
cyswllt	s+5	w
cysylltau	s8u	m
cysylltiad	s+I	x
cysylltiadau	s9U	0
cysylltiau	s/p	s
cysylltiedig	BDwQ	q
cysylltiedig	d2m	x
cysylltiol	d3X	m
cysylltnod	Cw0	u
cysylltnodau	Ph6	v
cysylltnodi	Bh+d	r
cysylltnodydd	Cxi	8
cysylltnodyddion	Pip	+
cysylltu	BvnH	h
cysyniad	tBv	p
cysyniadau	tA/	w
cytal	Bvno	l
cytbwys	tAV	q
cytgord	BH1H	v
cytgordiau	BR51	6
cythru	BvoN	f
cythruddo	Bvos	m
cythryblu	BvpS	l
cytio	Bvp3	Z
cytsain	BOs4	BB
cytseiniaid	BVGb	6
cytundeb	tDO	t
cytundebau	tCY	2
cytundebol	BH2u	l
cytundebu	BvqQ	n
cytunedig	BH3T	x
cytuno	Bvq3	k
cytûn	LJZ	e
cywain	Bvrb	h
cywair	BZ2Q	1
cywaith	Cye	o
cywasg	H2w	j
cywasgedd	W2R	6
cywasgedig	Eiw	w
cywasgedig	JiM	x
cywasgiad	V0J	+
cywasgiadau	Zl2	BF
cywasgu	BicV	f
cywasgu	BidX	l
cywasgu	Bvr8	h
cywasgydd	EiA	w
cywasgyddion	ReI	/
cyweiriau	BfCX	0
cyweirio	Bvsd	v
cyweithiau	Pjn	2
cywerth	LJ3	l
cywerthydd	Cz0	y
cywerthyddion	Pla	3
cywilyddio	BvtM	l
cywir	d39	r
cywirdeb	d4o	v
cywiriad	CzG	u
cywiriadau	Pkd	9
cywiro	Bvtx	g
cywirydd	VFf	7
cywiryddion	Yx7	BG
cywrain	BPwf	i
cywreinio	BvuR	j
cywydd	tFt	z
cywyddau	tD7	8
cywyddon	tE3	2
cywyddu	Bvu0	l
cân	oTz	c
cêl	JJR	a
côn	C5L	m
côr	p9A	g
cŵl	XIi	m
cŵn	pVJ	i
da	CFwk	b
dabio	BvvZ	j
dadamlblecsio	Bhxk	s
dadamlblecsydd	8K	+
dadamlblecsyddion	Nci	BB
dadamwysydd	xJ	4
dadamwysyddion	NPg	3
dadansoddi	Bvwl	p
dadansoddiad	tHS	t
dadansoddiadau	tGg	y
dadansoddydd	C0m	2
dadansoddyddion	PmR	7
dadbacio	BvxO	j
dadbwytho	Bvxx	l
dadddewis	BhNw	y
dadddirlenwi	BiEe	v
dadddocio	BhTz	v
dadddyfrio	Bvv8	p
dadebru	BvyW	p
dadelfennu	Bvy/	t
dadeni	Bvzs	k
dadfachu	Bv0Q	l
dadfeilio	Bv01	k
dadflino	Bv1Z	p
dadfritho	BhND	t
dadfrychu	BiSK	n
dadfygio	Bv2C	g
dadl	BCGY	8
dadlanastru	Bih9	z
dadlau	BCHU	BF
dadlau	Bv2i	h
dadlennu	Bv3D	l
dadleoli	Bv3o	m
dadleuol	d5X	n
dadleuon	BCIZ	BA
dadlewygu	Bv4O	q
dadluddedu	Bv44	z
dadlwytho	Bv5r	k
dadlygru	Bv6P	t
dadmer	Bv68	k
dadnamu	Bh/I	i
dadnamydd	C1c	s
dadnamyddion	PnM	5
dadocsideiddio	Bv7g	y
dadolwch	Bv8S	p
dadolychu	Bv87	q
dadorchuddio	Bv9l	k
dadosod	BhQP	5
dadosod	BiYd	s
dadosod	Bv+J	v
dadosodydd	EZj	3
dadosodyddion	RVN	BC
dadredeg	Bv+4	h
dadreoleiddio	Bv/Z	x
dadrithiad	BH4E	7
dadrithiadau	BR77	BD
dadrithio	BwAK	w
dadroddi	BwA6	k
dadrolio	BhRI	BW
dadsefydlu	BwBe	t
dadsgriwio	BwCL	w
daduno	BwC7	l
dadwaddoli	BwDg	o
dadweinio	BwEI	s
dadweithredoli	BiBA	1
dadwino	BwE0	n
dadwisgo	BwFb	k
dadwneud	BiAc	k
dadwraidd	BwF/	o
dadwrdd	BwGn	l
dadwreiddio	BwHM	m
dadyrddu	BwHy	l
daear	tIy	r
daearau	tH/	z
daearoedd	jnt	w
daearu	BwIX	i
daearyddiaeth	d5+	y
daearyddol	d6w	s
daeërydd	tJd	q
dafad	tpk	k
dagrau	/2x	0
daintio	BwI5	j
dal	BwJc	j
dalen	VGa	t
dalennau	YzB	1
dalennod	Wes	6
dalenodau	aWQ	BD
dalfan	BvZ	o
dalfannau	OXP	w
daliad	/4d	y
daliadau	/3l	4
daliwr	C2I	l
dall	Jqk	Y
dallgeibio	BwJ/	l
dallgopi	VHH	2
dallgopïau	Yz2	/
dallgopïo	BhEs	x
dallu	BwKk	e
dalwedd	VXF	BM
dalweddau	ZHN	BP
dalwyr	PoF	z
damcaniaethol	JkK	1
damcaniaethu	BwLC	o
damcanu	BwLq	d
damhegu	BwMH	y
damnio	BwM5	b
damnïol	BH4/	r
damsangu	BwNU	r
damwain	BwN/	g
damwain	tKy	s
damweiniau	tKH	r
damwynio	BwOf	k
dan	M3v	p
danfon	BwPD	g
dangos	BwPj	e
dangosair	BbiK	9
dangoseiriau	BgA4	BG
dangosiad	UZj	8
dangosiadau	YBv	BD
dangosydd	/6L	x
dangosydd	BR8	v
dangosydd	Vja	z
dangosyddion	/5P	8
dangosyddion	N17	4
dangosyddion	ZUM	6
danheddu	BwQB	g
dannedd	tLe	q
dannedd pwdr	BUCt	+
dant	tMI	i
dant pwdr	BMN/	s
dantio	BwQh	g
danto	BwRB	c
dantu	BwRd	b
darbodion maint	BH+U	BA
darbwyllo	BwR4	j
darfod	BkAx	i
darfodedig	Jlg	t
darganfod	BkBT	g
darganfod	BkBz	j
darganfyddiad	tNd	r
darganfyddiadau	tMq	z
dargludo	BwSb	h
dargopïo	BwS8	f
dargyfeirio	BwTb	j
darlith	BHn+	r
darlithio	BwT+	m
darlithoedd	BRxE	z
darllaw	BwUk	m
darllediad	tPG	1
darllediadau	tOI	+
darlledu	BwVK	r
darlledwr	BH/U	+
darlledwyr	BSAK	6
darllen	BwV1	o
darllenadwy	JmN	w
darllenadwyaeth	HOs	BA
darllenedig	Jm9	s
darllenwr	tQw	s
darllenwyr	tP7	1
darllenydd	tSN	s
darllenyddion	tRc	x
darlosgi	BwWd	k
darlun	tTt	q
darluniau	tS5	0
darlunio	BwXB	l
darluniwr	BIAS	6
darlunwyr	BSBE	7
darn	G5Z	h
darn	tVB	h
darn arian	BYuf	k
darn punt	BYvD	z
darnau	UH7	0
darnau	tUX	q
darnau arian	BeNQ	0
darnau punt	BeOE	2
darnguddio	BwXm	x
darnio	BwYX	d
darnladd	BwY0	n
darnodi	BwZb	k
darogan	BwZ/	n
daroganu	Bwam	h
darostwng	BwbH	l
darpar	d7c	u
darpar awdur	BbS3	2
darpar awduron	Bf59	2
darparedig	Jq8	t
darpariaeth	tWR	p
darpariaeth dameidiog	BNZk	Br
darpariaethau	tVi	v
darpariaethol	BICC	w
darparu	Bwbs	j
darparwr	tXv	u
darparwyr	tW6	1
darparydd	tZN	r
darparyddion	tYd	w
darsyllu	BwcP	o
darymred	Bwc3	q
data	d8K	p
datblygedig	d8z	l
datblygiad	tax	w
datblygiadau	tZ4	5
datblygiadol	BHjI	q
datblygol	BHif	p
datblygu	Bwdh	l
datblygu yn	BO/n	1
datblygwr	tca	v
datblygwyr	tbh	5
datgan	BweG	g
datganiad	td+	w
datganiadau	tdJ	1
datganiadol	BOio	x
datganoledig	BJX1	w
datganoli	Bwem	q
datganolwr	BICy	BA
datganolwyr	BSDB	BN
datganu	BwfQ	j
datgelu	Bwfz	j
datgloi	CFqg	e
datglymu	Bg/v	7
datglymu	BwgW	f
datgodio	Bh74	j
datgodydd	B7E	u
datgodyddion	Oje	u
datgofrestru	BiCU	w
datgorffori	Bwg1	y
datguddiad	BOaI	/
datguddiadau	BVC+	1
datguddio	Bwhn	l
datgyffesu	BwiM	l
datgymalu	Bwix	o
datgysylltiedig	JpL	6
datgysylltiol	JoW	1
datgysylltu	BwjZ	w
datgywasgu	BhOi	v
datgywasgu	BiDE	q
datgywasgu	BibC	p
datgywasgu	Bibr	q
datgywasgu	Bic0	j
dathliad	C3x	v
dathliadau	PqL	v
dathlu	BwkJ	o
datod	Bwkx	k
datrannu	BwlV	o
datroi	CFnn	f
datrys	Bwl9	n
datrysiad	tfl	s
datrysiadau	teu	3
datseilio	Bwmk	n
datseinio	BwnL	l
datselio	Bwnw	i
dau	BWzi	h
dau ddeg	BYxL	l
dauddimensiwn	BYwa	x
dawn	thC	m
dawns	tiP	g
dawnsiau	tho	n
dawnsio	BwoS	e
dawnswr	BHop	w
dawnswyr	BRx3	p
dawnus	JqF	f
ddim	BDkI	l
ddoe	Jt2	e
de	BYxw	k
de	BYz9	7
deall	Bwow	m
dealladwy	BIF9	n
dealltwriaeth	tjn	x
dealltwriaethau	tiv	4
deallus	XQJ	y
deallus	d9Y	h
deallusol	d95	z
deallusrwydd artiffisial	HRX	Bj
debyd	BIGk	m
debydau	BSFv	7
debydu	BwpW	i
decagon	BY04	j
decagonau	BeO6	q
decagram	BY1b	x
decagramau	BePk	1
decalitr	BY2M	z
decalitrau	BeQZ	0
decametr	BY2/	m
decametrau	BeRN	0
dechrau	Bwp4	h
dechrau	tlU	0
dechreuoedd	tkY	8
dechreuol	tmI	r
dechreuon	tmz	u
dechreuwr	DA8	t
dechreuwr	DAP	t
dechreuwyr	P0B	w
dechreuwyr	Pyd	w
decigram	BY3l	u
decigramau	BeSB	z
decilitr	BY4T	s
decilitrau	BeS0	0
decimetr	BY4/	s
decimetrau	BeTo	0
deddf	/71	w
deddfau	/68	5
deddfu	BwqZ	g
deddfwriaeth	BIHK	4
deddfwriaethau	BSGq	7
deddfwriaethol	d+s	t
deddwyrain	BYyU	w
dedfryd	toQ	s
dedfrydau	tnh	v
dedfrydu	Bwq5	i
defaid	to8	o
deffro	CFt5	f
deffroi	Bwrb	g
defni	Bwr7	e
defnydd	tq1	o
defnyddenw	BDq6	9
defnyddenwau	BP/7	BA
defnyddiadwy	JwL	y
defnyddiau	tqI	t
defnyddio	BwsZ	g
defnyddiol	d/Z	r
defnyddioldeb	DBp	4
defnyddioldebau	P0x	8
defnyddiwr	tsK	o
defnyddwyr	trd	t
defnynnu	Bws5	l
deg	BY5r	h
deg	Bahc	h
deg ar hugain	BcgF	s
degaid	tuN	p
degau	BeUc	p
degawd	tu2	r
degawdau	tsy	t
degeidiau	ttf	u
degfed	BW7y	m
degol	BXHb	h
degol	DCh	m
degol	Jw9	g
degoli	Bwte	l
degolion	Bd/r	0
degolion	P1t	v
degolion cylchol	BeAf	BE
degolyn	BYdZ	r
degolyn cylchol	BYeE	9
degwm	twJ	l
degymau	tvh	o
degymu	BwuD	d
deheuol	eAE	v
dehongli	Bwug	o
dehongliad	t5h	y
dehonglwr	BIIC	t
dehonglwyr	BSHl	v
dehonglydd	alQ	BJ
dehonglyddion	Y43	BN
deialo	BwvI	g
deialog	txd	q
deialogau	twu	v
deialu	Bwvo	f
deiet	ty0	l
deietegydd	BFb7	3
deietegyddion	BQtT	5
deiets	tyH	t
deifio	BwwH	f
deigryn	/14	5
deiliad	t0C	m
deiliaid	tzZ	p
deilio	Bwwm	g
deillio	BwxG	m
deinosor	BIJs	t
deinosoriaid	BSJR	w
deintio	Bwxs	h
deintydd	t1X	p
deintyddfa	BIKZ	BF
deintyddfaoedd	BSKB	BM
deintyddiaeth	BILe	0
deintyddion	t0o	v
deintyddol	eAz	o
deirydu	BwyN	k
deisebu	Bwyx	j
deisyf	BwzU	i
deisyfu	Bwz2	j
delffu	Bw0Z	k
delfryd	t2A	s
delfrydau	t2s	r
delfrydol	eBb	k
delfrydu	Bw09	n
deliadol	BIDy	s
deliau	BSEO	p
delifriad	BIMS	v
delifriadau	BSLN	z
delifro	BjcG	i
delio	Bw1k	d
delwaddoli	Bw2B	y
delwedd	t4A	p
delweddau	t3X	p
delweddu	Bw2z	h
delwi	Bw3U	o
democrataidd	BFcy	n
democrateiddio	Bw38	r
democratiaeth	BINB	5
demograffaidd	BIN6	u
demograffig	BFdZ	0
deng	eB/	g
deniadol	eCf	p
denu	Bw4n	m
deondai	BSMA	BE
deondy	BIPm	7
deongliadau	t4p	4
deoniaeth	BIOo	+
deor	Bw5N	g
deori	Bw5t	c
deorllewin	BYzE	5
derbyn	BiGi	i
derbyn	Bw6J	t
derbynebau	BeVF	z
derbynebau	P5D	3
derbyniad	t7M	v
derbyniad gwresog	BJoH	BE
derbyniadau	t6T	5
derbyniadau gwresog	BSvb	BK
derbyniedig	Jyx	x
derbynio	Bw62	g
derbyniol	eDI	j
derbyniwr	DG1	u
derbyniwr	DGG	v
derbyniwr	t8x	t
derbynneb	BY6M	s
derbynneb	DFZ	t
derbynnydd	t+R	v
derbynnyddion	t9e	z
derbynwyr	P56	3
derbynwyr	P6x	0
derbynwyr	t77	2
derw	t/t	m
derwen	t/A	t
dethol	Bw7W	e
detholedig	XQ7	w
detholiad	uBB	p
detholiadau	uAT	u
detholiadol	BIRH	o
detholus	BIQh	m
deuaidd	Jzi	i
deuddeg	BWrM	k
deuddegfed	BWrw	m
deuffordd	J0E	m
deufis	BIRv	y
deufisoedd	BSNE	/
deufisol	BFeN	t
deugain	BW8Y	k
deugeinfed	Ba0A	5
deugyfeiriol	J0q	5
deunaw	BGVQ	f
deunawfed	Ba05	u
deunydd	uCh	r
deunyddiau	uBq	3
deuocsid	eDr	t
deuol	J2P	c
deuparth	BISh	2
deuparthau	BSOD	9
dewin	DJH	j
dewiniaid	P9J	0
dewinio	Bw70	i
dewis	BhSe	v
dewis	Bw8W	e
dewis	uFR	u
dewisau	uDM	t
dewisiad	/Jz	q
dewisiadau	uD5	s
dewisiedig	XSj	5
dewislen	VMb	BB
dewislenni	Y7O	BG
dewisoedd	uEl	s
dewisol	eEY	r
dewisydd	DDH	s
dewisyddion	P2c	7
dewr	eFD	g
diabetes	eFj	s
diadellu	Bw80	i
diaelodi	Bw9W	l
diagnosis	eGP	o
diagnosteg	DDz	z
diagnostegau	P3X	0
diagnostig	Jxd	t
diagram	uGv	m
diagram cangen	BY64	3
diagramau	uF/	w
diagramau cangen	BeV4	+
dial	Bw97	m
diamedr	BY7v	r
diamedrau	BeW2	z
diamod	Jrp	l
diamwys	Xxu	v
dianc	Bw+h	d
diangen	eG3	n
dianghenrhaid	BITX	s
dianghenu	Bw++	l
dianrhydeddu	Bw/j	t
diarfogi	BxAQ	d
diargraff	BDxr	BA
diarhebu	BxAt	o
diarwydd	XUg	2
diasbedain	BxBV	n
diasgellu	BxB8	u
diatal	BdGm	2
diau	BIUD	g
diau	BOo6	d
diau fod 	BOpX	+
diawlio	BxCq	j
diben	uIB	l
dibenion	uHV	s
dibennu	BxDN	l
diboblogi	BxDy	r
dibriddo	BxEd	m
dibriod	BIUj	q
dibrisiad	DJq	y
dibrisiadau	P99	6
dibrisiadwy	XRr	4
dibrisio	BxFD	j
dibrofiad	BFe6	1
dibwys	J4l	h
dibynadwy	eHe	p
dibyniaeth	DKc	z
dibyniaethau	P+3	2
dibynnol	eIH	k
dibynnu	BxFm	i
dibynnydd	VI4	3
dibynyddion	Y13	BA
dichellu	BxGI	y
dichlynu	BxG6	k
diclloni	BxHe	r
did	Ue5	q
didau	YHu	x
diddanu	BxIJ	j
diddiwedd	I77	n
diddordeb	uJW	q
diddordebau	uIm	w
diddori	BxIs	l
diddorol	eIr	v
diddosi	BxJR	v
diddwylo	BIWa	s
diddwytho	BxKA	l
diddyfnu	BxKl	g
diddymu	BhGn	1
diddymu	BxLF	j
diderfyn	JsO	n
didfap	Bl9	k
didfapiau	OMV	t
didol	BxLo	k
didoli	BxMM	m
didor	BIV0	m
didor	BYv2	k
didrafferth	BIVN	n
didreiddedd	HEh	y
didroedio	BxMy	m
diduedd	BY8a	g
diduedd	I8i	m
didynnu	BxNY	k
dieithr	BbU6	q
dieithr	eJa	k
dieithriaid	Bf7n	0
dieithrio	BxN8	k
dieneidio	BxOg	h
dienw	J2r	g
dienyddio	BxPB	o
dienyddu	BxPp	k
diesgyrnu	BxQN	m
diet	uKt	l
diets	uKA	t
difa	BxQz	j
difaterwch	BIXG	p
difeddiannu	BxRW	s
difeio	BxSC	u
difenwad	BIXv	u
difenwadau	BSPA	5
difenwi	BxSw	l
diferion	Y23	8
diferu	BxTV	b
diferyn	VJv	1
diferynnu	BxTw	r
difetha	BxUb	g
difethu	BxU7	g
diffeithio	BxVb	l
diffeithwch	BIYd	0
diffiniad	uL/	p
diffiniadau	uLS	t
diffiniedig	J3L	v
diffinio	BxWA	o
diffodd	BjCY	l
diffodd	BxWo	m
diffrwytho	BxXO	o
diffryd	BxX2	m
diffurfdro	Km/	u
diffyg	uNZ	m
diffygio	BxYc	i
diffygiol	K80	p
diffygion	uMo	x
diffyn	BxY+	h
diffynnydd	uOy	t
diffynyddion	uN/	z
difin	BIZR	g
diflanedig	Ks3	u
diflannu	BxZf	o
diflas	BHe3	k
diflas	J7Y	g
diflasu	BxaH	p
difodi	Bxaw	m
difreinio	Bxb2	s
difreintiedig	eJ+	w
difrif	BIZx	l
difrifol	eKu	j
difrifoldeb	VKk	8
difrifoldebau	Y3z	BE
difrifoli	Bxci	u
difriwyr	BSE3	4
difrod	uQQ	p
difrodau	uPf	x
difrodi	BxdQ	j
difrïo	BxbW	g
difrïwr	BIFG	3
difuddio	Bxdz	k
difwlch	J74	i
difwyno	BxeX	m
difyr	eLR	t
difyrru	Bxe9	m
dig	J8a	Z
digais	JH8	p
digalonni	Bxfj	p
digaregu	BxgM	t
digennu	Bxg5	g
digid	DMD	k
digidau	QAp	x
digidol	eL+	l
digio	BxhZ	j
digolledu	Bxh8	t
digomisiynu	Bxip	y
digon	uRn	k
digonedd	uQ5	u
digoni	Bxjb	j
digonol	eMj	k
digroeni	Bxj+	g
digwydd	Bxke	p
digwyddiad	uS6	p
digwyddiadau	uSL	v
digwyddiadol	J8z	2
digymraeg	BFfv	0
digyswllt	Jnp	t
dihangol	BOeA	m
dihangu	BxlH	r
diharffu	Bxly	n
dihatru	BxmZ	m
dihatryd	Bxm/	l
diheintio	Bxnk	m
diheintydd	uUj	0
diheintyddion	uTj	BA
dihengyd	BxoK	i
diheuro	Bxos	h
dihidlo	BxpN	i
dihoeni	Bxpv	n
dihuno	BxqW	g
dihydradu	Bxq2	o
dihysbyddu	Bxre	k
dileu	BxsC	h
dillad	uWL	s
dilladu	Bxsj	j
dilledyn	uVX	0
dilorni	BxtG	s
diluddedu	Bxty	o
dilyn	Bxua	f
dilynedig	J+M	t
dilyniannau	uXl	s
dilyniannol	MNN	r
dilyniannydd	C5x	3
dilyniant	uW3	u
dilynianyddion	Prs	3
dilynol	J+5	l
dilynol	eNH	o
dilynydd	C4g	r
dilynyddion	Pq6	y
dilys	eNv	g
dilysiad	DMn	x
dilysiad	DNY	t
dilysiadau	QBa	+
dilysiadau	QCY	y
dilysrwydd	HS6	0
dilysrwydd	eOP	t
dilysu	Bxu5	l
dilysydd	DOF	t
dilysyddion	QDK	4
dim	BCe3	Y
dim	BY86	k
dim	BY9e	s
dim na	LvC	p
dimensiwn	uZC	z
dimensiynau	uYR	x
dinas	uam	m
dinasoedd	uZ1	x
dinaswr	ub8	m
dinaswyr	ubM	w
dinasyddiaeth	eUr	y
dinasyddion	udP	w
dinesig	asJ	d
dinesydd	uci	t
dinistrio	Bxve	l
dinistriol	BIbG	o
dinodi	BxwD	n
dinoethi	Bxwq	h
diod	uhd	n
dioddef	BxxL	h
dioddef	eVd	t
dioddefaint	BIaW	w
dioddefwr	ugL	m
dioddefwyr	ufa	x
diodi	Bxxs	r
diodydd	ugx	s
diofryd	BxyX	k
diofrydu	Bxy7	n
diofynnu	Bxzi	k
diog	Jtc	a
diogel	eWK	o
diogelu	Bx0G	h
diogelwch	eWy	q
diogelydd sgrin	DOy	BI
diogelyddion sgrin	QEC	BG
diogi	Bx0n	d
diolch	Bx1E	h
diolch	uet	t
diolchiadau	ud/	u
diorsedd	Bx1l	k
diorseddu	Bx2J	l
diosg	Bx2u	f
diosgi	Bx3N	d
diosod	XVW	p
diota	Bx3q	g
dipio	Bx4K	g
diploma	BIbu	u
diplomâu	BSP5	s
dipo	Bx4q	Z
diraddio	Bx5D	j
diraenu	Bx5m	d
dirboeni	Bx6D	h
dirdynnu	Bx6k	g
dirgelu	Bx7E	m
dirgrynu	Bx7q	l
diri	BIcc	o
diriaethol	BIdE	x
diriaethu	Bx8P	t
dirisglo	Bx88	i
dirlawn	JuU	k
dirlawnder	HPs	y
dirlenwi	BiDu	w
dirmygu	Bx9e	k
dirnad	Bx+C	n
dirnadu	Bx+p	j
dirprwy	VOT	y
dirprwy	uiE	o
dirprwyedig	BId1	x
dirprwyo	BiJo	k
dirprwyo	Bx/M	n
dirprwyol	XV/	v
dirprwyon	Y9Q	7
dirprwyon	uis	o
dirwy	/9a	v
dirwyn	BhTN	m
dirwynu	Bx/z	h
dirwyo	ByAU	c
dirwyon	/8l	1
dirymedig	J/e	u
dirymu	ByAw	k
dirywiad	ukG	y
dirywiadau	ujU	y
dirywio	ByBU	o
dis	VPF	m
disbaddu	ByB8	l
disbeinio	ByCh	k
disberod	BOLC	r
disbyddu	ByDF	h
disg	uln	j
disgiau	uk4	v
disglair	eXc	j
disglein	MW9	m
disgleirdeb	HTu	2
disgleirio	ByDm	k
disgownt	BWbe	t
disgowntiau	BWcL	2
disgresiwn	BIem	z
disgrifiad	um9	s
disgrifiadau	umK	z
disgrifiadol	KAM	3
disgrifio	ByEK	p
disgwyl	ByEz	l
disgwyliad	uon	0
disgwyliadau	unp	+
disgwyliedig	eX/	r
disgybl	uqR	q
disgyblaeth	BIfZ	5
disgyblaeth	eYq	x
disgyblaethau	BSQl	5
disgyblaethu	ByFY	s
disgyblion	upb	2
disgyblu	ByGE	s
disgyn	ByGw	m
disgynnol	KBD	r
disgyrchiant	Wyw	6
disgyrchu	ByHW	n
disgyrrwr	BY+7	7
disiau	Y+L	s
disodli	ByH9	u
distaw	KBu	f
distawrwydd	eZb	4
distewi	ByIr	l
distrywio	ByJQ	k
distyllio	ByJ0	m
distyllu	ByKa	j
diswyddiad	urw	u
diswyddiadau	uq7	1
diswyddo	ByK9	k
disychedu	ByLh	s
disychu	ByMN	q
ditio	ByM3	h
diwahodd	M5s	o
diwallu	ByNY	k
diwedd	use	u
diweddar	eaT	p
diweddarach	ea8	v
diweddaraf	ebr	r
diweddaredig	KCN	y
diweddariad	DP6	x
diweddariadau	QFI	2
diweddaru	ByN8	p
diweddion	utM	q
diweddnodiad	Ce3	2
diweddnodiadau	PMz	4
diweddu	ByOl	j
diweinio	ByPI	j
diweithdra	ecW	1
diwerth	Ju4	i
diwetha	XWu	r
diwethaf	BBbc	x
diwifr	XuR	w
diwraidd	ByPr	i
diwreiddio	ByQN	p
diwrnod	BDLG	x
diwrnodau	BDL3	y
diwrnodwedyn	BIgS	9
diwyd	BIhP	p
diwydiannau	uug	z
diwydiannol	edL	u
diwydiant	ut2	q
diwyg	BIh4	6
diwygiad	uwA	v
diwygiadau	uvT	t
diwygiedig	ed5	q
diwygio	ByQ2	j
diwylliannau	uxk	w
diwylliannol	eej	v
diwylliant	uwv	1
diwyllio	ByRZ	o
diwyno	BySB	f
diwyro	BySg	p
diymatal	BPjd	2
diymddiriedol	Mx3	3
diystyried	ByTJ	n
diystyru	ByTw	l
dobio	ByUV	d
doc	BIiy	m
dociau	BSRe	w
docio	BhUi	o
doctora	ByUy	h
doctoran	ByVT	m
docydd	DQr	m
docydd	VPr	x
docyddion	QF+	BA
docyddion	Y+3	4
dod	BkCW	f
dod i rym	Bh/q	y
dodecagon	BY/2	n
dodecagonau	BeXp	v
dodi	ByV5	f
dodrefn	uzM	y
dodrefnu	ByWY	i
dodrefnyn	uyU	4
dodwy	ByW6	j
doeth	efS	n
doethinebu	ByXd	q
dofi	ByYH	a
dofn	BCRt	m
dogfen	u0t	o
dogfennaeth	HQe	5
dogfennau	uz+	v
dogfennu	BiIa	m
dogni	ByYh	h
dolefain	ByZC	f
dolen	BV9C	h
dolen	BVcL	v
dolenni	BWOE	p
dolenni	BWPk	6
dolennu	ByZh	o
doler	VNc	3
doleri	Y8U	8
dolurio	ByaJ	f
domestig	ef5	s
domino	BZAd	h
dominos	BeYY	w
dominyddu	Byao	k
doniau	tgR	x
donio	BybM	h
dos	u19	h
dosbarth	u3L	j
dosbarthiad	u3u	9
dosbarthiadau	u2e	t
dosbarthu	Bybt	o
dosbarthwr	DSq	y
dosbarthwyr	QIp	4
dosranedig	Hz/	s
dosraniad	VSK	8
dosraniadau	ZBo	/
dosrannu	BiKw	k
dosrannu	BycV	k
dosrannydd	BHmQ	3
dosranyddion	BRwL	5
dosys	u1V	o
dot	DT/	b
dotiau	QKO	o
dotio	Byc5	j
dotwaith	DUa	q
dotweithiau	QK2	v
drabio	Bydc	j
drachefn	BFgj	k
drachefn	BPnC	l
drachtio	Byd/	j
draen	DVE	i
draenio	Byei	h
drafft	+7l	l
drafftiau	+8K	r
drafftio	ByfD	f
dragio	Byfi	f
drama	u5S	n
dramateiddio	BygB	r
dramatig	egl	i
dramodwr	BIjY	q
dramodwyr	BSSO	2
dramâu	u4r	n
dreflu	Bygs	h
dreiniau	QLl	n
drensio	ByhN	h
drewi	Byhu	g
driblo	ByiO	p
drifftio	Byi3	g
driflo	ByjX	g
drilio	Byj3	d
dringo	BykU	e
dripian	Byky	g
dro ar ôl tro	BPSh	Bg
dros	KFd	Z
dros dro	BdD/	9
drosodd	KF2	g
drosti	KGW	h
drosto	KG3	h
drud	ehH	k
drudfawr	BIko	n
drutach	BZA+	z
drutaf	BZBx	s
drwg	ehr	c
drwgdybio	BylS	k
drwodd	KHY	g
drws	u6f	e
drwy	BB5E	c
drwy gydol y nos	BPuE	BA
drwyddo	KH4	m
drych	DWL	j
drychau	QM/	q
drygioni	BIlP	s
drygu	Byl2	e
dryllio	BymU	h
drysau	u55	m
drysedig	KIe	q
drysu	Bym1	f
dryswch	eiH	o
dull	u7k	h
dulliau	u69	n
duo	BynU	i
duon	/Tq	y
duw	BVhL	i
duwiau	BWCq	0
dwbio	Byn2	b
dwbl	BZDZ	l
dwbl	eiv	c
dwblglicio	BiJA	o
dwdlio	ByoR	g
dweud	Byox	a
dwfn	Jvz	Y
dwlu	BypL	a
dwmpian	Bypl	e
dwplecs	KJr	h
dwrdio	ByqD	e
dwsin	BZE8	w
dwsinau	Beay	w
dwy	BWzB	h
dwyfoli	Byqh	e
dwyieithog	ejL	m
dwyieithrwydd	ejx	v
dwylo	u8p	i
dwyn	Byq/	a
dwyn ir blaen	BMiK	BL
dwyrain	ekg	r
dwyrannu	ByrZ	h
dwyreiniol	BDzb	m
dwyreiniol	BFhH	u
dwys	elL	n
dwysach	BPqT	p
dwysbigo	Bysd	w
dwysedd	u9z	m
dwyseddau	u9L	o
dwysfyfyrio	BytN	t
dwysgyfalafol	BIl7	z
dwyso	Byt6	i
dwysáu	Byr6	j
dwywaith	ely	h
dwywaithyflwyddyn	BFh1	1
dy	BCOg	g
dyblau	BeaJ	p
dyblo	Byuc	e
dyblu	Byu6	j
dyblyg	KJI	j
dyblygedig	KKM	y
dyblygiad	DWu	x
dyblygiadau	QNp	x
dyblygu	BiLU	p
dyblygu	Byvd	s
dybryd	BImu	m
dychanu	BywJ	g
dychlamu	Bywp	f
dychmygiad	DXf	0
dychmygiadau	QOa	z
dychmygion	u/K	w
dychmygol	KK+	p
dychmygu	BiL9	n
dychmygu	ByxI	h
dychmygydd	DYT	y
dychmygyddion	QPN	9
dychryn	Byxp	l
dychryn	vAp	r
dychryniadau	u/6	v
dychrynu	ByyO	j
dychweliad	BInU	3
dychweliadau	BST5	5
dychweliadol	KLn	z
dychwelyd	Bi/y	u
dychwelyd	Byyx	j
dychwelydd	DZF	2
dychwelyddion	QQK	BC
dychymyg	ByzU	l
dychymyg	u+Z	x
dydd	/+J	r
dydd gwener	BDP2	z
dydd iau	BKa7	p
dydd llun	BDOd	s
dydd mawrth	BLJ0	z
dydd mercher	BDPJ	t
dydd sadwrn	BDQp	2
dydd sul	BDRf	y
dyddiad	vCG	k
dyddiadau	vBU	y
dyddiadur	vDb	n
dyddiaduron	vCq	x
dyddiau	vEC	u
dyddiedig	emT	e
dyddio	Byz5	d
dyddiol	emx	h
dyddlyfr	Dau	q
dyddlyfrau	QSH	1
dyddodi	By0W	j
dyfais	vEw	r
dyfalbarhau	By05	o
dyfalu	By1h	m
dyfarniad	vGI	p
dyfarniadau	vFb	t
dyfarnu	By2H	k
dyfarnwr	BIoL	x
dyfarnwyr	BSUy	z
dyfeisgar	BIo8	o
dyfeisgarwch	BIpk	w
dyfeisiau	vGx	z
dyfeisio	By2r	k
dyffryn	vIS	r
dyffrynnoedd	vHk	u
dyfnach	BZD+	f
dyfnaf	BZEd	f
dyfnder	vJu	l
dyfnderoedd	vI9	x
dyfnhau	By3P	n
dyfnion	BCST	j
dyfodiad	vLF	p
dyfodiadau	vKT	y
dyfodol	enS	s
dyfrhau	By32	f
dyfrio	By4V	f
dyfrlliw	DbY	v
dyfrlliwiau	QS8	/
dyfroedd	vN+	p
dyfru	By40	h
dyfynedig	KNE	r
dyfyniad	vMl	t
dyfyniadau	vLu	3
dyfynnod	DcH	y
dyfynnu	By5V	g
dyfynodau	QT7	2
dyfynodi	By51	h
dygnu	By6W	e
dygyforio	By60	r
dygymod	By7f	p
dyhead	vPQ	s
dyheadau	vOn	p
dyheu	By8I	n
dyhuddo	By8v	h
dylanwad	vQx	r
dylanwadau	vP8	1
dylanwadu	By9Q	t
dyled	vSL	j
dyledion	vRc	v
dyledus	BIqU	n
dyledwr	BIr7	p
dyledwyr	BSVl	s
dyletswydd	vTd	m
dyletswyddau	vSu	v
dylifo	By99	g
dylu	By+d	f
dyluniad	++F	q
dyluniadau	++v	o
dylunio	BiNK	i
dylunio	By+8	n
dyluniwr	VVc	0
dylunwyr	ZFY	6
dylunydd	VUr	x
dylunyddion	ZEe	6
dyma	BB1Z	Y
dymchwel	By/j	r
dymchweliad	vVA	y
dymchweliadau	vUD	9
dympio	BzAO	f
dymunadwy	BIsk	BA
dymunaf ddiolch iddo	BbGZ	9
dymuniad	vWn	p
dymuniadau	vVy	1
dymuno	BzAt	e
dymunol	Iur	l
dymunol	en+	k
dyn	C2t	b
dyna	eoi	h
dynamig	Ixy	j
dynesu	BzBy	i
dynesáu	BzBL	n
dynion	Po4	q
dynodedig	epD	q
dynodi	BzCU	f
dynodiad	CD0	m
dynodiadau	Otx	m
dynol	ept	a
dynoli	BzCz	k
dynwared	BzDX	l
dyraniad	vYI	v
dyraniadau	vXQ	4
dyrannu	BzD8	j
dyrchafael	BzEf	k
dyrchafedig	KPE	v
dyrchafol	KMa	q
dyrchafu	BzFD	h
dyrifo	BzFk	g
dyrnfedd	BZFs	w
dyrnfeddi	Bebi	4
dyrnod	BzGE	f
dyrnu	BzGj	l
dyroddi	BzHI	k
dyrys	KPz	h
dysg	eqH	v
dysgu	BzHs	f
dysgub	BzIL	j
dysgwr	vZo	n
dysgwyr	vY3	x
dywalhau	BzIu	l
dywalu	BzJT	n
dyweddïo	BzJ6	j
dywediad	C+7	q
dywediadau	Pxg	9
dywedyd	BzKd	e
dêl	BIEe	o
dŵr	vNS	s
dŵr hallt	BV3x	s
eang	eq2	f
easesu	BI1A	BA
eb	erV	X
ebargofi	BzK7	j
ebe	ers	Y
ebillio	BzLe	e
ebost	va3	j
ebostach	Wzq	0
ebostau	vaP	o
ebostio	BzL8	m
ebostydd	Dc5	q
ebostyddion	QUx	x
ebrannu	BzMi	p
ebrill	BVXN	n
ebychu	BzNL	k
ebyr	vba	o
ebyrth	vcC	p
echdoe	BZGc	y
echdoe	BZJs	v
echdorri	BzNv	i
echdynnu	BzOR	k
echdynnydd	Ddj	x
echdynyddion	QVi	3
echelin	VWQ	1
echelin fertigol	BZHO	1
echelin lorwedd	BZID	3
echelinau	ZGS	7
echelinau fertigol	Beca	BG
echelinau llorwedd	Bedg	6
echnos	BZI6	y
echnos	BZKb	8
echrydio	BzO1	h
echrydu	BzPW	f
ecolegol	esE	h
economaidd	esl	j
economeg	Bc6U	2
economi	vdX	p
economïau	vcr	s
ecsbloetio	BzP1	n
ecsgliwsif	BIxk	t
edafedd	ZIc	BI
edafeddedig	XYM	BC
edafeddu	BhVK	BC
edau	VYR	+
eddysgu	BI2A	r
edfryd	BzQc	j
edifar	BIyR	6
edifarhau	BzQ/	l
edifaru	BzRk	i
edifeirio	BzSG	o
edliw	BzSu	f
edliwio	BzTN	n
edmygu	BzT0	j
edrych	BzUX	l
edrychiad	vey	r
edrychiadau	veA	y
edrychyd	BzU8	e
edwino	BzVa	f
efallai	etI	p
efasnach	BIzL	y
efe	e/F	h
efelychiad	Dez	y
efelychiadau	QXI	5
efelychu	BzV5	l
efelychydd	Dfl	y
efelychyddion	QYB	w
efengyl	vgQ	o
efengylau	vfd	z
efengylu	BzWe	k
eferwi	BzXC	l
effaith	vhp	o
effeithiau	vg4	x
effeithio	BzXn	k
effeithiol	etx	u
effeithioli	BzYL	x
effeithiolrwydd	euf	2
effeithlon	viR	r
effeithlonrwydd	vi8	z
effro	evV	i
efo	ev3	n
efryd	BOBH	6
efrydiau	BU5h	BB
efrydio	BzY8	l
efrydu	BzZh	f
efydd	BI0c	k
efydd	BIz9	f
efyddau	BSYE	q
egino	BzaA	l
eglur	ewe	c
eglurder	ew6	m
eglurhad	vkl	7
eglurhadau	vjv	2
egluro	Bzal	p
egluryn	DgX	s
eglurynnau	QYx	3
eglwys	vmT	o
eglwysi	vlg	z
eglwysig	exg	p
egni	xJg	m
egnioli	BzbO	k
egnïoedd	xIu	y
egnïol	eyJ	n
egnïon	xH6	0
egru	Bzby	c
egwyddor	vns	r
egwyddorion	vm7	x
egwyl	//o	u
egwyliau	/+0	0
egyhoeddi	BI2r	x
ehangach	eyw	u
ehangedig	KRF	s
ehangu	Bhiz	2
ehangu	BzcO	h
ehedeg	Bzcv	g
ehedfan	BzdP	g
ehudo	Bzdv	d
ehyfforddi	BI3c	x
ei	BB+L	T
ei	BB4p	b
ei gilydd	H2D	t
eich	BBpI	k
eicon	vpG	m
eiconau	voX	v
eiconeiddio	BiNs	o
eiconig	KRx	k
eiddigeddu	BzeM	h
eiddo	eze	p
eiddoch	BCS2	h
eidduno	Bzet	k
eidion	vqZ	m
eidionnau	vps	t
eilaidd	BI4N	q
eildro	BI43	x
eiledol	KSV	p
eiledu	BzfR	j
eiliad	BABO	y
eiliadau	BAAW	4
eilio	Bzf0	g
eillio	BzgU	p
eilradd	KUy	k
eilrif	Bb+d	BD
eilrif	DhD	r
eilrifau	BgQ/	BJ
eilrifau	QZo	4
eilunaddoli	Bzg9	w
eilwaith	e0H	g
ein	e/m	Y
einglgymreig	BI5o	t
eingo	Bzht	j
eira	e0n	h
eirch	lmx	l
eiriasu	BziQ	m
eirin	Qag	s
eirinen	Dhu	o
eirio	Bzi2	d
eiriol	BzjT	q
eiriolaeth	BI7K	4
eirioli	Bzj9	h
eiriolwr	BI6V	1
eiriolwyr	BSYu	6
eironig	BI8C	k
eisiau	jqk	p
eisoes	e1I	j
eistedd	Bzke	i
eisteddfod	vr7	1
eisteddfodau	vq/	8
eisteddfodol	BVht	BC
eitem	vth	p
eitemau	vsw	x
eitemeiddio	BzlA	l
eitha	BI8m	v
eitha debyg	KWX	9
eithaf	+/X	k
eithaf	KV3	g
eithaf	KVW	h
eithafol	e1r	i
eithr	BV2H	w
eithr	fRs	f
eithriad	vu6	q
eithriadau	vuK	w
eithriadol	e2N	q
eithriadu	Bzll	j
eithriedig	e23	r
eithrio	BzmI	j
eithro	Bjco	g
electronfolt	DiW	7
electronfoltiau	QbM	6
electronig	e3i	v
eleni	e4R	p
elfen	vwV	n
elfennau	vvk	x
elfennol	BI9V	p
eliffant	vxr	o
eliffantod	vw8	v
elips	BZLX	y
elipsau	Beea	q
elitaidd	BDmI	l
ellyll	VZP	3
ellyllon	ZJk	+
elusen	vzE	o
elusennau	vyT	x
elusennol	e46	v
elw	v0Y	l
elwa	Bzmr	f
elwau	vzs	s
elythyr	BI9+	o
elythyrau	BSZo	0
embargo	BI+m	q
embargoau	BSac	4
emeritws	BI/Q	l
emosiwn	BI/1	p
emosiynau	BSbU	s
emosiynol	e5p	l
emwlseiddio	BznK	x
emyn	v1g	e
emynau	v09	j
enaid	v2l	g
enamlio	Bzn7	n
enbyd	e6O	o
enbydrwydd	BJBW	r
enchwythu	Bzoi	l
encil	BzpH	c
encilio	Bzpj	r
endid	DTc	j
endidau	QJh	t
eneidiau	v1+	n
eneinio	BzqO	h
enfawr	e62	o
enghraifft	v33	p
enghreifftiau	v3F	y
enghreifftio	Bzqv	r
enghreifftiol	e7e	r
englyn	v5e	1
englynion	v4g	+
englynu	Bzra	q
engyl	v6T	o
enhuddo	BzsE	k
enillion	BefE	u
enillion	v8D	n
enillwr	v9S	p
enillwyr	v8q	o
enillwyrgwobrau	BScA	6
enillydd	v97	q
enillyddgwobr	BJAe	4
enllib	BJCB	w
enllibau	BSc6	s
enllibio	Bzso	l
ennill	BZMJ	n
ennill	BztN	j
ennill	v7e	l
ennyn	Bztw	g
enrhifiad	VaG	0
enrhifiadau	ZKi	8
enrhifo	BzuQ	m
ensynio	Bzu2	n
entropi	HVZ	p
enw	v/K	j
enw gwesteiwr	DkA	8
enwad	wAR	f
enwadau	v/t	k
enwadur	DjR	v
enwadur cyffredin	BZMw	+
enwaduron	QcG	u
enwaduron cyffredin	Befy	BX
enwaedu	Bzvd	k
enwau	v+l	l
enwau gwesteiwr	Qc0	/
enwebedig	e8J	l
enwebiad	BJCx	w
enwebiadau	BSdm	2
enwebu	BzwB	g
enwedig	e8u	s
enwi	Bzwh	e
enwocaf	e9a	u
enwog	e+I	i
enwogi	Bzw/	m
enwogion	BJDh	x
enwol	KYC	e
enynnu	Bzxl	i
eoca	BzyH	o
eog	wAw	m
eogiaid	BBps	u
epidemiolegol	BEiK	0
epilio	Bzyv	g
eplesu	BzzP	j
epoc	Dk8	h
epocau	Qdz	u
er mwyn	BPGC	x
eraill	e/+	d
erbyn	e+q	b
erbyn meddwl	BOZM	8
erchi	Bzzy	g
erchyll	fAb	f
erecriwtio	BJES	0
erfyn	Bz0S	d
erfyn	Dld	h
erfyn	fA6	i
erfynio	Bz0v	j
erglywed	Bz1S	j
ergyd	BAC4	t
ergydio	Bz11	e
ergydion	BACA	4
erioed	fBc	d
erledigaeth	BEhb	v
erledigaethau	BQay	3
erlid	Bz2T	d
erlyn	Bz2w	g
erlyniad	+3Q	w
erlynu	Bz3Q	j
ers	fB5	a
erthygl	wB+	m
erthyglau	wBW	o
erthylu	Bz3z	i
erw	wDM	i
erwau	wCk	o
erydu	Bz4V	c
esblygu	Bz4x	g
esboniad	wEc	p
esboniadau	wDu	u
esboniadol	BJFG	t
esbonio	Bz5R	i
esbonydd	Va6	y
esbonyddion	ZLe	5
esbonyddol	H0r	w
esemptiad	BEi+	3
esemptiadau	BQbp	1
esgeuluso	Bz5z	l
esgeulustod	fCT	v
esgeulustra	BJFz	0
esgid	wF1	k
esgidiau	wFF	w
esgob	wHG	k
esgobaeth	wId	r
esgobaethau	wHq	z
esgobion	wGZ	t
esgor	Bz6Y	i
esgus	wJ7	r
esgusion	wJI	z
esgusodi	Bz66	k
esgyll	N8i	BK
esgymuno	Bz7e	q
esgyn	Bz8I	p
esgynnol	KYg	o
esgyrn	mUT	m
esiampl	wLW	n
esiamplau	wKm	w
esmwyth	Bc1M	i
esmwyth	fDC	c
esmwytho	Bz9X	s
esmwytháu	Bz8x	m
estraddodi	Bz+D	v
estron	wMt	p
estroneiddio	Bz+y	n
estroniaid	wL9	w
estyn	Bz/Z	h
estynadwy	Dl+	w
estynadwy	KZI	v
estynedig	fDe	v
estyniad	wOI	q
estyniadau	wNW	y
ethnig	fEN	g
ethol	Bz/6	g
etholaeth	wPu	w
etholaethau	wOy	8
etholedig	fEt	s
etholi	B0Aa	m
etholiad	wRU	u
etholiadau	wQe	2
etholiadol	fFZ	o
etholwr	wSz	n
etholwyr	wSC	x
etholydd	wTa	p
ethos	fGB	s
etifeddiaeth	Dmu	5
etifeddiaeth	Dnn	3
etifeddiaethau	QfU	x
etifeddiaethau	QgF	u
etifeddio	B0BA	u
etifeddol	Doe	t
etifeddol	DpL	t
etifeddol	KZ3	u
etifeddu	B0Bu	h
eto	KXU	W
eto	KXq	Y
eto	XZO	i
eu	fGt	k
euog	fHR	d
euro	B0CP	b
ewrop	BEj1	w
ewropeaidd	BEkl	o
ewtroffeiddio	B0Cq	r
ewyllys	wUt	n
ewyllysiau	wUD	q
ewyllysio	B0DV	o
ewyllysu	B0D9	m
ewynnu	B0Ej	c
fan	BJGn	p
fandaleiddio	B0E/	z
faniau	BSec	q
fansïau	QkJ	v
farneisio	B0Fy	q
fe	BB1x	v
fe	BDIi	m
fe ellid dweud bod 	BOue	BD
fechan	BCTX	j
fector	Dp4	l
fectorau	Qgz	2
fed	XZw	BC
fel	BDXx	j
fel	Kbj	W
fel arall	KS+	r
fel arfer	ML1	p
fel iau ar ei war	BOn6	BA
fel petai	MCP	m
fel rheol	Xti	v
fel y cyfryw	BMpp	6
felly	fHu	W
fer	BCT6	g
fercwri	W0e	4
fersiwn	wWG	p
fersiwn deuaidd	VLg	7
fersiynau	wVU	y
fersiynau deuaidd	Y6E	BK
fertig	BZNu	m
fertigau	BehJ	+
fertigol	Kb5	o
fesul	Kch	b
fesul dyfais	Kg9	0
fesul gair	Kdn	y
fesul gwesteiwr	KgC	7
fesul llinell	KeZ	1
fesul tudalen	KfO	0
fesul un	Dqd	v
fesul un	Kc8	r
feto	B0Gc	h
ffa	BQjZ	j
ffa pob	BEx+	q
ffabrigo	B0G9	l
ffacs	wXY	i
ffacsio	BiOy	i
ffacsys	wWv	p
ffactor	wYi	i
ffactor graddfa	BZOU	z
ffactorau	wX6	o
ffactorau graddfa	BeiH	5
ffactorial	Dr3	u
ffactorialau	Qil	y
ffactorio	B0Hi	r
ffaelu	B0IN	g
ffafrio	B0It	e
ffafriol	fIE	l
ffaglu	B0JL	h
ffagodi	B0Js	s
ffair	wZs	h
ffaith	wa2	g
ffaldio	B0KY	h
ffalsio	B0K5	g
ffansi	Dsl	i
ffansïo	B0LZ	f
ffantasi	DtH	r
ffantasïau	QjX	y
ffarmio	B0L4	g
ffarwelio	B0MY	j
ffasgu	B0M7	n
ffasiwn	wcD	l
ffasiynau	wbW	t
ffasno	B0Ni	g
ffatio	B0OC	e
ffatri	wdX	o
ffatrïoedd	wco	v
ffedereiddio	B0Og	p
ffefryn	wex	n
ffefrynnau	wd/	y
ffeibr	BEmH	t
ffeibrau	BQce	t
ffeil	wgC	i
ffeil gofnod	CGw	2
ffeiliau	wfY	q
ffeiliau cofnod	OxD	w
ffeilio	B0PJ	d
ffeindio	B0Pm	d
ffeiriau	wZE	o
ffeirio	B0QD	e
ffeithiau	waN	p
ffeithiol	fIp	i
ffemto	Khx	d
ffenest	fJL	m
ffenestr	whP	l
ffenestri	wgk	r
ffenomen	BEm0	8
ffenomenau	BQdL	1
ffens	wid	k
ffensio	B0Qh	p
ffensys	wh0	p
fferm	wjn	f
ffermio	B0RK	f
ffermwr	fJx	p
ffermwyr	fKa	o
ffermydd	wjB	m
fferru	B0Rp	h
fferyllfa	BEoZ	z
fferyllfeydd	BQeA	BE
fferylliaeth	BEpM	6
fferyllol	BEnw	p
fferyllwr	BEqG	u
fferyllwyr	BQfE	5
ffeuen	BExQ	u
ffi	BEq0	m
ffidlan	B0SK	h
ffidlo	B0Sr	f
ffieiddio	B0TK	i
ffigur	BWdB	w
ffigurau	BWdx	5
ffigwr	BWeq	z
ffigyrau	BWfd	7
ffilm	wkt	f
ffilmiau	wkG	n
ffilmio	B0Ts	d
ffin	Dty	g
ffin	wl3	i
ffindir	HWC	n
ffiniau	Qk4	t
ffiniau	wlM	r
ffinio	B0UJ	h
ffiniol	KiO	l
ffisegol	fLC	j
ffisiolegydd	BEra	0
ffisiolegyddion	BQgk	8
ffisiotherapi	BEsO	v
ffisiotherapydd	BEs9	BC
ffisiotherapyddion	BQhg	BC
ffit	fLl	b
ffitio	B0Uq	b
ffitrwydd	fMA	t
ffiwdalhau	B0VF	p
ffiwsio	B0Vu	e
fflach	DuS	j
fflachiau	Qll	r
fflachio	B0WM	g
fflamio	B0Ws	e
fflamychu	B0XK	k
fflangellu	B0Xu	k
fflasg	BV6/	u
fflasgiau	BWL6	p
fflat	wnA	f
fflatiau	wmZ	n
fflatio	B0YS	j
fflyrtio	B0Y1	g
ffo	/Uc	t
ffoadur	woL	j
ffoaduriaid	wnf	s
ffocws	wpf	n
ffocysedig	BEt/	v
ffocysys	wou	x
ffodus	fMt	e
ffoi	CFq+	d
ffoli	B0ZV	d
ffon	wqr	h
ffon fesur	BZPH	o
ffon fesur	BaX/	/
ffon fetr	BZPv	/
ffonau	wrM	h
ffonau cellol	Oii	8
ffonio	B0Zy	h
ffont	DeU	f
ffontiau	QWZ	v
fforchio	B0aT	e
ffordd	wsv	g
fforddiadwy	fNL	q
fforddiadwyedd	BEuu	BA
fforddio	B0ax	i
fforffedu	B0bT	h
fformadu	BiPU	l
fformat	BCE3	t
fformatiau	BCFk	0
fformatio	B0b0	h
fformig	Kiz	h
fformiwla	wt5	n
fformiwleiddio	B0cV	q
fformiwlâu	wtP	q
ffortiwn	Du1	p
ffortiynau	QmQ	s
fforwm	wvQ	m
fforymau	wug	w
ffos	wwf	h
ffosileiddio	B0c/	p
ffosydd	wv2	p
ffoto	Dve	h
ffotograff	wxx	q
ffotograffau	wxA	x
ffotograffiaeth	BbXu	0
ffotograffwr	BEvu	6
ffotograffwyr	BQii	3
ffotos	Qm8	o
ffracsiwn	Dv/	r
ffracsiwn pendrwm	BZQu	Bx
ffracsiynau	Qnk	x
ffracsiynau pendrwm	Bekw	B4
ffracsiynol	KjU	s
ffraeo	B0do	j
ffrainc	HWp	l
fframiau	wyb	y
fframio	B0eL	h
fframwaith	w0k	r
fframweithiau	wz0	w
ffres	fN1	d
ffrewyllio	B0es	w
ffrewyllu	B0fc	t
ffrind	w1/	n
ffrindiau	w1P	w
ffrio	B0gJ	b
ffroenell	Dwq	r
ffroenellau	QoV	q
ffroeni	B0gk	e
ffromi	B0hC	h
ffrwcsio	B0hj	r
ffrwd	w3Q	i
ffrwd rss	DxV	4
ffrwtian	B0iO	f
ffrwydrad	DyN	s
ffrwydradau	Qpx	0
ffrwydro	B0it	j
ffrwydrydd	Dy5	t
ffrwydryddion	Qql	/
ffrwydryn	Vct	2
ffrwydrynnau	ZNj	BA
ffrwyno	B0jQ	f
ffrwyth	w4b	j
ffrwythau	w3y	p
ffrwythloni	B0jv	o
ffrwytho	B0kX	m
ffrydiau	w2m	q
ffrydiau rss	Qo/	y
ffrydio	B0k9	j
ffrâm	wzN	n
ffug	BDpw	b
ffug	fOS	l
ffugbasio	B0lg	h
ffugenw	Dzm	n
ffugenw	Vdj	t
ffugenwau	Qrk	w
ffugenwau	ZOj	z
ffugio	B0mB	l
ffugio	BiP5	o
ffuglen	BJIA	i
ffugliwio	B0mm	n
ffullio	B0nN	g
ffuredu	B0nt	m
ffureta	B0oT	i
ffurf	BADl	v
ffurfdroadol	KmJ	2
ffurfdroi	BiQh	h
ffurfdroëdig	KlY	x
ffurfdroëdig	VeQ	y
ffurfiad	VgE	6
ffurfiadau	ZQf	5
ffurfiannol	KoW	r
ffurfiau	BAEU	w
ffurfiedig	Knt	p
ffurfio	B0o1	i
ffurfiol	jod	s
ffurfioldeb	BOkO	3
ffurfioli	BjdI	v
ffurflen	BAFE	w
ffurflenni	BAF0	3
ffurfweddadwy	KpB	4
ffurfweddiad	VfC	BC
ffurfweddiadau	ZPW	BJ
ffurfweddu	B0pX	o
ffustio	B0p/	i
ffusto	B0qh	f
ffwbar	Vbs	BB
ffwbariau	ZMX	BM
ffwdanu	B0rA	e
ffwndro	B0re	n
ffwrdd	w5j	h
ffwythiant	Vg+	6
ffydd	w6p	h
ffyddiau	w6E	l
ffyddlon	fO3	h
ffyn	wqG	l
ffyn mesur	BejA	s
ffyn mesur	Bfb2	BE
ffyn metr	Bejs	BE
ffynci	BEwo	o
ffynhonnell	w72	p
ffyniannus	fPY	m
ffyniant	fP+	s
ffynnu	B0sF	g
ffynonellau	w7K	s
ffyrdd	w4+	l
ffyrdd	wsM	j
ffyrm	BJIi	q
ffyrmiau	BSfG	1
ffyrnig	fQq	j
ffyrnigo	B0sl	j
ffïoedd	BQf9	n
ffôn	wrt	f
ffôn cellol	B6J	7
fi	BCpc	W
fictimeiddio	B0tI	o
fideo	w9M	o
fideos	w8f	t
fioled	D2A	l
fioledau	QuJ	3
fo	BDJI	l
fod	BViv	X
fory	fRN	f
fwythiannau	ZRY	BD
fy	BB97	Q
fyny	Kq0	a
gadael	B0tw	e
gaeaf	w+d	l
gaeafau	w90	p
gaeafgysgu	B0uO	l
gaeafu	B0uz	j
gaeleg	BVjj	+
gafael	B0vW	p
gafael	w/v	j
gafaelion	w/C	t
gafr	xA6	l
gair	xCE	e
gair ir gall	BbjH	7
galaeth	D7Y	o
galaethau	Qz/	x
galarnadu	B0v/	m
galarnadus	BPNy	x
galaru	B0wl	o
galfaneiddio	B0xN	t
gallu	B0x6	j
gallu	D8A	n
gallu	VkN	z
galluoedd	Q0w	0
galluoedd	ZVG	+
galluog	V/P	6
galluog	eR2	g
galluogi	B0yd	p
galw	B0zG	b
galw	eSW	w
galwad	xDM	i
galwadau	xCi	q
galwai	D8n	l
galwedigaethol	eRK	s
galweion	Q1k	t
galwr	D9M	j
galwyn	D9v	l
galwyni	Q2+	r
galwyr	Q2R	t
gama	Ktl	Z
gamblo	B0zh	p
gan	BB6d	T
gan amlaf	BDw6	x
gan un nad oes ganddo mor amynedd	BPOj	B8
ganddi	eO8	h
ganddi hi	BC40	t
ganddo	ePd	m
ganddo ef	BC5h	q
ganddo fe	BC6L	z
ganddo fo	BC6+	z
ganddyn	eQD	j
ganddyn nhw	BC7x	u
ganddynt	eQm	k
ganddynt hwy	BC8f	v
garanu	B00K	o
gardd	xEZ	j
garddio	B00y	o
garddwriaeth	BJKn	BA
garw	cA5	f
garwhau	B01a	f
gefeillio	B015	g
gefynnu	B02Z	h
geifr	xAS	o
geirfa	xFs	n
geirfaoedd	xE8	w
geiriad	BbOz	v
geiriadau	Bf5S	r
geiriadur	xHN	t
geiriaduron	xGT	6
geiriau	xBf	l
geirio	B026	j
gelyn	D/1	j
gelynion	Q3p	o
gemau	xKG	p
gen i	BC9O	o
gen ti	BC92	x
genedigaeth	xL7	n
genedigaethau	xLP	s
generadu	B03d	l
generig	eUJ	i
geneth	BJKH	g
genethod	BSf7	q
genetig	BJLn	i
geneuol	BJMJ	m
geni	B04C	k
gennych	BCUa	n
gennych chi	BDG9	z
gennych chwi	BDCv	0
gennyf	eTG	l
gennyf fi	BDEK	s
gennym	eTr	e
gennym ni	BC/U	n
gennyn ni	BDBV	r
gennyt	/TB	p
gennyt ti	BDFe	z
geometreg	EAY	z
geometregau	Q4R	w
geometrig	Kve	u
ger	KwM	X
gerbron	fSL	q
gerddi	xDu	r
gerllaw	fS1	d
gerwino	B04m	p
gesio	B05P	f
glafoeri	B05u	q
glafoerio	B06Y	h
glain	BZSf	v
glan	xNX	v
glanhad	ECt	n
glanhadau	Q7D	u
glanhau	B065	j
glanio	B07c	e
glannau	xMi	1
glas	KxY	b
glasbrint	BJNY	v
glasbrintiau	BSgl	5
glasenwi	B076	n
glasoed	BJOH	9
glastwreiddio	B08h	r
glasu	B09M	n
glaswellt	fTx	p
glaswenu	B09z	h
glaw	EDU	f
glaw mân	FBi	w
glawio	B0+U	g
glawogydd	Q7x	n
glawogydd mân	R/e	w
gleidio	B0+0	r
gleiniau	Bemo	2
gliniadur	Uv+	3
gliniadur	UvN	x
gliniaduron	YZ/	4
gliniaduron	Ya3	8
gloddesta	B0/f	l
glowyr	xOG	q
gloywder	HXO	v
gloywi	B1AE	k
gludio	B1Ao	e
gludo	BiTS	m
gludog	Kxz	j
glyniad	BJPE	s
glyniadau	BShe	r
glynu	B1BG	h
glythu	B1Bn	h
glân	fTS	f
glöwr	xOw	l
gobaith	xP/	l
gobeithio	B1CI	i
gobeithion	xPV	q
goblygiad	xRb	w
goblygiadau	xQk	3
goblygu	B1Cq	k
goddef	B1DO	f
goddefiad	BJPw	x
goddefiadau	BSiJ	w
goddefol	KyW	n
goddiweddyd	B1Dt	n
godinebu	B1EU	q
godro	B1E+	g
gofal	xSL	v
gofalu	B1Fe	k
gofalus	Ky9	j
gofalwr	xTm	l
gofalwyr	xS6	s
gofalydd	BJSB	y
gofalyddion	BSj5	6
goferu	B1GC	o
goferwi	B1Gq	o
gofid	BEbE	u
gofidiau	BQXw	v
gofidio	B1HS	f
gofod	BBc6	9
gofod	EEh	p
gofodau	Q9M	y
gofodol	BJSz	k
gofyn	B1Hx	c
gofyn	Bj3z	k
gofyn	xU7	r
gofyn am	BbFx	o
gofyniad	xWU	n
gofyniadau	xVm	u
gofynion	xUL	w
gofynnod	EFK	y
gofynnol	fUa	k
gofynodau	Q9+	2
goganu	B1IN	j
goglais	B1Iw	j
gogledd	fU+	r
gogleddddwyrain	BZTO	6
gogleddol	fVp	o
gogleddorllewin	BZUI	3
gogleisio	B1JT	m
gogleisiol	BJTX	o
gogoneddu	B1J5	k
gogoniannau	xW7	2
gogoniant	xXx	q
gogr	EF8	h
gograu	Q+0	p
gogru	B1Kd	e
gogrwn	B1K7	g
gogrynu	B1Lb	o
gogwydd	BJT/	s
gogwyddion	BSkz	0
gogwyddo	B1MD	s
gogyfer â	BJUr	3
gohebiaeth	fWR	0
gohebu	B1Mv	k
gohebwyr	xaK	5
gohebydd	xZX	z
gohebyddion	xYb	8
gohiriad	EGd	t
gohiriadau	Q/d	1
gohiriedig	Kzg	w
gohirio	B1NT	k
golau	EHK	j
golau cylch	F+h	1
golchi	B1N3	h
goledd	BZU/	x
goleddau	Bene	u
goleddfu	B1OY	l
goleddol	BZWU	x
goleddu	Bjzl	k
goleuad	BAGr	w
goleuadau	BAHb	2
goleuau	RAS	o
goleuau cylch	TGA	4
goleuni	/cw	t
goleuo	B1O9	l
golff	fXF	p
gollwng	B1Pi	l
gollyngiad	xb1	v
gollyngiadau	xbD	y
gollyngus	K0o	m
golwg	BWgY	j
golwg	Eaa	j
golygedig	K1O	t
golygfa	xda	q
golygfeydd	xck	2
golygon	BWg7	q
golygon	BWhl	l
golygu	B1QH	d
golygwyr	xeE	w
golygydd	xfi	s
golygyddion	xe0	u
golygyddol	BJVi	q
goramser	BZZt	o
goramser	EIi	r
goramserau	RB2	v
goramseru	BiUW	l
gorarchebu	Bjeg	o
gorau	K17	c
gorboethi	B1RP	n
gorbrisio	B1R2	n
gorbwysleisio	B1Sd	w
gorchestol	BPx/	t
gorchestu	B1TN	t
gorchfygu	B1T6	p
gorchfygu	Bj4X	m
gorchfygus	BOem	v
gorchmynion	xhC	x
gorchudd	xik	v
gorchuddio	B1Uj	o
gorchuddion	xhz	x
gorchwyl	fXu	t
gorchwylion	xjT	x
gorchymyn	B1VL	w
gorchymyn	xgO	0
gorddefnyddio	B1V7	r
gordderchu	B1Wm	o
gorddibynnu	B1XO	1
gorddrafft	BZaV	y
gorddrafftiau	BerC	1
gorddweud	B1Qk	r
gordewdra	BJWM	y
gordyfu	B1YD	l
goresgyn	B1Yo	v
goresgyniad	xk1	y
goresgyniadau	xkE	x
goreuro	B1ZX	j
gorffen	B1Z6	s
gorffenedig	fYb	k
gorffeniad	xmk	z
gorffeniadau	xln	9
gorffennaf	BDZC	j
gorffennol	fY/	p
gorffwylledd	BJW+	3
gorffwys	xoM	p
gorffwysion	xnX	1
gorffwyso	B1am	j
gorflino	B1bJ	o
gorfod	BkC1	f
gorfodaeth	xpr	v
gorfodaethau	xo1	2
gorfodi	B1bx	k
gorfodi	BiU7	f
gorfodol	K2X	p
gorfodol	fZo	w
gorfoleddu	B1cV	p
gorfoleddus	faY	t
gorfynych	BLoi	v
gorgodiad	BZbH	x
gorgodiadau	Ber3	3
gorgyffwrdd	B1c+	p
gorgyffyrddiad	xrX	2
gorgyffyrddiadau	xqa	9
gorgyflenwi	B1dn	u
gorgyhoeddi	BjfI	q
gorgymhlethdod	BJZO	BB
gorgymhlethdodau	BSmZ	BB
gori	B1eV	g
goriwaered	BPfx	1
gorlenwi	B1e1	t
gorlifo	B1fi	p
gorliwio	B1gL	w
gorllewin	fbF	r
gorllewinol	fbw	w
gorlwytho	B1g7	j
gormesu	B1he	l
gormod	xuv	n
gormodiaith	BPhS	q
gormodieithol	BPh8	v
gormodion	xt8	z
gornest	EKF	p
gornestau	RDj	y
goroesi	B1iD	l
gorofalu	B1io	w
gorsaf	xtK	y
gorsafoedd	xsN	9
gorseddu	B1jY	o
gorstocio	Bjfy	o
gorswm	BJaP	u
gorsymiau	BSna	+
gorthrechu	B1kA	p
gorthrymu	B1kp	o
goruchel	K3A	o
goruchwyliaeth	BAJW	BK
goruchwyliaethau	BAIR	BF
goruchwylio	B1lR	t
goruchwyliwr	xw6	w
goruchwylwyr	xwJ	x
goruwchlywodraethu	B1l+	y
gorwahannod	VRS	4
gorwahanodau	ZAq	+
gorwario	Bj0J	s
gorwedd	B1mw	p
gorweithio	B1nZ	q
gorwel	BJb8	n
gorwelion	BSoY	x
gorwlychu	B1oD	q
gorymdeithio	B1ot	5
goryrru	B1pm	h
gosod	B1qH	k
gosod	fcg	n
gosod her	BPDs	7
gosodiad	xyg	z
gosodiadau	xxq	2
gosodol	Xbj	p
gostegu	B1qr	n
gostwng	B1rS	r
gostwng	BiVa	l
gostyngedig	fdH	v
gostyngiad	x0N	w
gostyngiadau	xzT	6
gradd	x1y	q
graddau	x09	1
graddau canradd	BX0D	BA
graddedigion	BJdU	v
graddfa	x3J	m
graddfeydd	x2c	t
graddiannau	ZYO	/
graddiant	Vm2	2
graddio	B1r9	l
graddio	BjFA	n
graddliw	WOn	3
graddliwiau	aD0	+
graddliwio	Bhbk	t
graddlwyd	K3o	r
graddnodi	B1si	l
graddol	fd2	i
graddoli	B1tH	l
graeanu	B1ts	l
graenio	B1uR	n
graenu	B1u4	n
graenus	BbOD	w
graff	x4e	m
graff gwasgariad	BZcv	5
graff trawsnewid	BZdo	8
graffau gwasgariad	Besu	BE
graffau trawsnewid	Bety	BE
graffeg	feY	0
graffiau	x3v	v
graffig	ffM	l
graffigau	Y/v	7
graffigol	KC/	q
graffigyn	VQc	2
gram	BZek	n
gramadeg	jpJ	u
gramau	Beu2	u
grant	x5w	k
grantiau	x5E	s
greddfu	B1vf	t
grediniol	BJcj	x
gresynu	B1wM	k
grid	x67	f
griddfan	B1ww	j
griddfanu	B1xT	j
gridiau	x6U	n
grillianu	B1x2	k
gris	ELr	h
grisiau	RFS	r
gronyn	x8I	m
gronynnau	x7a	u
gros	BJf7	d
gruddfanu	B1ya	k
grwgnach	B1y+	l
grwnan	B1zj	i
grwpiau	x8u	r
grwpio	B10F	i
grym	x+p	k
grymoedd	x99	s
grymus	ffx	j
grymuso	B10n	o
grŵp	x9Z	k
gwacach	BZfL	4
gwacaf	BZgD	w
gwacter	EMM	q
gwacterau	RG4	w
gwactod	HX9	n
gwacáu	B11P	h
gwaddodi	B11w	m
gwaddoli	B12W	h
gwaddota	B123	r
gwadnu	B13i	d
gwadu	B13/	g
gwaed	x/3	h
gwaedau	x/N	q
gwaedlif	BJrx	w
gwaedlifau	BSym	4
gwaedoedd	yAY	r
gwaedu	B14f	h
gwael	fgU	i
gwaelod	yBt	s
gwaelodi	B15A	o
gwaelodion	yBD	q
gwaelodol	K5X	t
gwaelu	B15o	k
gwaeth	fg2	f
gwaethaf	fhV	g
gwaethygu	B16M	p
gwag	K6E	d
gwagariadau	BS6A	4
gwagio	B161	g
gwagle	BJsh	v
gwagleoedd	BSze	BE
gwagsymera	B17V	p
gwagu	B17+	f
gwahaniad	BJuN	u
gwahaniadau	BS0i	5
gwahaniaeth	yDS	x
gwahaniaethau	yCZ	5
gwahaniaethol	BJtQ	9
gwahaniaethu	B18d	z
gwahannod	DRR	u
gwahanodau	QG+	6
gwahanodiad	BJu7	BF
gwahanodiadau	BS1b	BM
gwahanol	fh1	l
gwahanu	B19Q	m
gwahanydd	EM2	u
gwahanyddion	RF9	7
gwahardd	B192	p
gwaharddiad	yFA	1
gwaharddiadau	yED	9
gwahodd	B1+f	j
gwahoddedig	K7C	w
gwahoddedig	yGu	t
gwahoddedigion	yF1	5
gwahoddiad	yIa	4
gwahoddiadau	yHb	/
gwahân	K6h	h
gwair	yKD	m
gwaith	BAMi	0
gwaith	yKp	n
gwalcio	B1/C	r
gwall	yL0	j
gwallau	yLQ	k
gwallgof	K7y	h
gwallgofi	B1/t	j
gwallt	yyH	m
gwallus	K8T	h
gwallus	XcM	u
gwalteisio	B2AQ	h
gwaltysu	B2Ax	f
gwamalu	B2BQ	k
gwamalu	Bjtf	h
gwan	K9d	Y
gwan	Xc6	s
gwancu	B2B0	k
gwanedu	B2CY	m
gwangalonni	B2C+	r
gwanhau	B2Dp	h
gwanobeithio	B2EK	m
gwanu	B2Ew	h
gwanwyn	fia	p
gwanwyno	B2FR	x
gwanychu	B2GC	i
gwar	BOm3	BD
gwaradwyddo	B2Gk	u
gwarafun	B2HS	g
gwarant	yNC	l
gwarantau	yMX	r
gwarantu	B2Hy	n
gwarchae	B2IZ	k
gwarchod	B2I9	q
gwarchodaeth	yOa	s
gwarchodaethau	yNn	z
gwarchodedig	K91	z
gwarchodwr	BJzL	u
gwarchodwyr	BS4P	5
gwaredigaeth	yQF	4
gwaredigaethau	yPG	/
gwaredu	B2Jn	l
gwareiddio	B2KM	n
gwarged	BJz5	z
gwargedion	BS5I	4
gwargrymu	B2Kz	j
gwarhau	B2LW	f
gwariannau	yTm	y
gwariant	ySz	z
gwario	B2L1	h
gwarrau	BVEf	7
gwarro	B2MW	k
gwartheg	yR/	0
gwarthegyn	yQ9	BC
gwarthruddo	B2M6	r
gwas	yVB	o
gwasanaeth	yWa	q
gwasanaethau	yVp	x
gwasanaethu	B2Nl	k
gwasg	Vns	z
gwasgaredig	fjD	p
gwasgariad	BJ0s	x
gwasgaru	B2OJ	i
gwasgau	ZZN	7
gwasgedd	HYk	s
gwasgiad bysell	Wfm	BJ
gwasgiad llygoden	Whw	BR
gwasgiadau bysell	aXT	BR
gwasgiadau llygoden	aZt	Bb
gwasgu	B2Or	g
gwastad	fjs	f
gwastatu	B2P1	p
gwastatáu	B2PL	q
gwastraff	fkL	y
gwastraffu	B2Qe	l
gwastrodaeth	B2RD	q
gwastrodi	B2Rt	k
gwatwar	B2SR	g
gwau	B2Sx	h
gwawchio	B2TS	q
gwawdio	B2T8	j
gwawrio	B2Uf	e
gwe	EPL	d
gwead	EPo	l
gweadau	RKB	w
gwedd	yX5	t
gweddau	yXE	1
gweddill	fk9	q
gweddill	yZV	o
gweddillio	B2Va	l
gweddillion	yYm	v
gweddnewid	B2V/	o
gweddol	BB3z	c
gweddu	B2Wn	f
gwedduso	B2XG	s
gweddw	fln	h
gweddwhau	B2Xy	n
gweddïo	B2U9	d
gwefan	yau	q
gwefannau	yZ9	x
gwefeistr	BVS	x
gwefeistri	N5k	4
gwefreiddio	B2YZ	t
gwefru	B2ZG	r
gwegian	B2Zx	m
gwehyddu	B2aX	l
gweiddi	B2a8	n
gweini	B2bj	f
gweinidog	ycK	r
gweinidogaethu	B2cC	s
gweinidogion	ybY	y
gweinidogol	BJ2R	w
gweinydd	Ubf	2
gweinyddiaeth	BDWC	3
gweinyddiaeth	BJ3B	7
gweinyddiaethau	BDW5	4
gweinyddiaethau	BS64	6
gweinyddion	YD4	BB
gweinyddol	fm1	t
gweinyddu	B2cu	l
gweinyddwr	EOU	3
gweinyddwyr	RIf	2
gweiriau	yJS	x
gweisg	BZ4L	BB
gweision	yUY	p
gweithdai	yc1	5
gweithdrefn	Guc	0
gweithdrefn	yfS	w
gweithdrefnau	T8D	v
gweithdrefnau	yef	z
gweithdy	ydu	x
gweithfeydd	/dd	2
gweithfwrdd	BCDB	4
gweithfyrddau	BCD5	+
gweithgar	fni	v
gweithgaredd	yg9	0
gweithgareddau	ygC	7
gweithgarwch	foR	0
gweithgor	yiz	4
gweithgorau	yhx	BC
gweithgynhyrchion	yks	BC
gweithgynhyrchu	B2dT	s
gweithgynnyrch	yjr	BB
gweithiau	BAKg	BF
gweithiau	BALl	9
gweithio	B2d/	h
gweithiwr	ymi	5
gweithle	yoO	v
gweithlen	ENk	w
gweithlenni	RHo	3
gweithleodd	ynb	z
gweithlu	yp1	u
gweithluoedd	yo9	4
gweithred	ysS	x
gweithredadwy	Xfl	1
gweithredai	Vpa	4
gweithredeion	ZbH	+
gweithrediad	yqj	6
gweithrediad gwrthdro	BZgz	BX
gweithrediadau	yrd	1
gweithrediadau gwrthdro	Bevk	BX
gweithrediaeth	BVc6	BB
gweithrediaeth yr alban	BVeh	BH
gweithrediaethau	BV/m	5
gweithredoedd	ytD	9
gweithredol	fpF	p
gweithredoli	Bhtu	r
gweithredoliannau	RKx	9
gweithredoliant	EQN	BE
gweithredu	B2eg	1
gweithredu	Bg8h	z
gweithredu	BjFn	5
gweithredwr	yu0	5
gweithredwragedd	BU9m	BF
gweithredwraig	BOFq	w
gweithredwyr	yuA	0
gweithredydd	Vof	7
gweithredyddion	ZaI	/
gweithwyr	ylu	0
gweitied	B2fV	l
gweitio	B2f6	t
gweladwy	K+o	o
gweld	B2gn	f
gwelediad	ERR	t
gwelediadau	RLu	w
gweledig	K/Q	o
gweledigaeth	BAOV	2
gweledigaethau	BANW	/
gweledol	/BC	g
gwell	fpu	m
gwella	B2hG	o
gwellhau	B2hu	m
gwelliannau	Pwn	5
gwelliannau	yvt	6
gwelliannu	B2iU	n
gwelliant	C+L	w
gwelliant	ywn	2
gwellt	yxd	q
gwelltyn	BAPL	BG
gwelltyn	yyt	v
gwelwi	B2i7	b
gwely	yz/	k
gwelyau	yzc	j
gwelydd	ER+	o
gwelyddion	RMe	7
gwen	BCZX	h
gwendid	y1S	o
gwendidau	y0j	v
gwenieithio	B2jW	l
gwenieithu	B2j7	n
gwenu	B2ki	i
gwenwyn	y2p	o
gwenwynau	y16	v
gwenwyno	B2lE	i
gweoedd	RJV	s
gwepio	B2lm	l
gwerdd	BCZ4	i
gwerin	y3+	l
gwerinoedd	y3R	t
gwers	y5R	l
gwersi	y4j	u
gwersyll	y6h	k
gwersylla	B2mL	n
gwersylloedd	y52	r
gwerth	y95	z
gwerth lle	BZiK	z
gwerthadwy	BJ38	y
gwerthfawr	fqU	u
gwerthfawrogi	B2my	q
gwerthfawrogiad	y8F	3
gwerthfawrogiadau	y7F	BA
gwerthiannau	y/Z	q
gwerthiant	y+s	t
gwerthoedd	y88	9
gwerthoedd lle	Bew7	BN
gwerthu	B2nc	i
gwerthusiad	zA4	1
gwerthusiadau	zAD	1
gwerthuso	BiV/	l
gwerthwr	zCk	v
gwerthwrgorau	BIwz	x
gwerthwyr	zBt	3
gwerthwyrgorau	BSXG	+
gwerthyd	B2n+	w
gweru	B2ou	i
gwerydu	B2pQ	z
gweryru	B2qD	i
gwestai	zDT	q
gwestai	zEo	n
gwestai gwadd	BJgY	8
gwesteia	BhWM	5
gwesteion	zD9	r
gwesteion gwadd	BSrI	7
gwesteiwr	VqS	8
gwesteiwyr	ZcF	BD
gwesty	zFP	q
gwestyau	zF5	p
gweu	B2ql	e
gwgu	B2rD	c
gwialenodi	B2rf	k
gwibio	B2sD	g
gwichian	B2sj	g
gwifrau	T8y	n
gwifren	GvQ	m
gwifrio	B2tD	f
gwin	BVyn	f
gwingo	B2ti	o
gwinoedd	BWIE	t
gwir	K/4	a
gwireddu	B2uK	j
gwirfoddol	frC	l
gwirfoddoli	B2ut	q
gwirfoddolwr	zHT	y
gwirfoddolwyr	zGi	x
gwiriad	BARY	4
gwiriadau	BAQR	BH
gwirio	B2vX	g
gwirio sillafu	Bi5t	r
gwirionedd	zI8	z
gwirioneddau	zIF	3
gwirioneddol	frn	o
gwirioneddu	B2v3	r
gwirioni	B2wi	k
gwirwerth	WjB	5
gwirwerthoedd	abI	BG
gwirydd sillafu	GIc	BG
gwiryddion sillafu	TTP	9
gwisg	zKk	p
gwisgo	B2xG	o
gwisgoedd	zJv	1
gwiweru	B2xu	p
gwlad	zL9	l
gwladol	/VJ	r
gwladoli	B2yX	x
gwladychu	B2zI	o
gwlana	B2zw	m
gwledd	BJnZ	u
gwledda	B20W	i
gwleddoedd	BSug	7
gwledig	fsP	m
gwledydd	zLN	w
gwleidydd	ESm	z
gwleidyddiaeth	BJ4u	6
gwleidyddion	RNZ	8
gwleidyddol	fs1	z
gwleidyddoli	B204	u
gwlyb	fto	h
gwlychu	B21m	m
gwneud	Bj+k	o
gwneud newidiadau mân	BMjV	BJ
gwneuthuriad	ETZ	2
gwneuthuriadau	ROV	z
gwneuthurwr	zNa	z
gwneuthurwyr	zMi	4
gwnïo	B22M	d
gwobr	zPB	w
gwobrau	zON	0
gwobrwyo	B22p	l
gwragedd	zPx	o
gwraidd	zSb	y
gwraig	zQZ	i
gwrandawiad	zRv	s
gwrandawiadau	zQ7	0
gwrando	B23O	u
gwregysu	B238	k
gwreica	B24g	o
gwreichioni	B25I	p
gwreiddiau	zT4	p
gwreiddio	B25x	h
gwreiddiol	fuJ	v
gwreiddioldeb	BPvu	x
gwreiddyn	zTN	r
gwres	fu4	l
gwresog	BJpL	h
gwresogi	B26S	k
gwresydd	BVu+	u
gwresyddion	BWFV	r
gwrhydau	BeyI	7
gwrido	B262	g
gwrogaethol	BO1X	m
gwrogi	B27W	r
gwroli	B28B	l
gwrteithio	B28m	p
gwrth	fvd	l
gwrthamgenu	Bhvf	y
gwrthblaid	BJps	BL
gwrthbleidiau	BSwl	BF
gwrthbleidlais	BJq3	6
gwrthbleidleisiau	BSxq	8
gwrthbrofi	B296	o
gwrthbrofi	Bj01	j
gwrthbwyso	B2+i	s
gwrthbwysol	BJ5o	2
gwrthdaro	B2/O	p
gwrthddadleuo	B2/3	w
gwrthddweud	B29P	r
gwrthddywedyd	B3An	w
gwrthdrawiad	BBwf	s
gwrthdrawiadau	BBxL	z
gwrthdro	LAS	m
gwrthdro	VsU	3
gwrthdroedig	LA4	v
gwrthdroeon	ZeW	8
gwrthdroi	B3BX	o
gwrthdroi	BiWk	p
gwrthdystio	B3B/	o
gwrthganu	B3Cn	t
gwrthgilio	B3DU	t
gwrthglocwedd	JVa	2
gwrthgyferbynnu	B3EB	u
gwrthgyferbynnu	B3Ev	w
gwrthgymdeithasol	BJ6e	8
gwrthgymraeg	BJ7a	7
gwrthgymreictod	BJ8V	BP
gwrthgymreig	BJ9k	BI
gwrthiant	W1W	7
gwrthneidio	B3Ff	o
gwrthod	B3GH	n
gwrthod	BiXN	m
gwrthrych	zVR	u
gwrthrychau	zUh	w
gwrthrychedd	BJ+s	9
gwrthrychol	fwC	n
gwrthryfela	B3Gu	y
gwrthsefyll	B3Hg	2
gwrthsoddi	B3IW	v
gwrthuno	B3JF	j
gwrthwasgu	B3Jo	t
gwrthweithio	B3KV	r
gwrthwneud	BkDU	o
gwrthwyneb	zWy	v
gwrthwynebau	zV/	z
gwrthwynebiad	zYd	1
gwrthwynebiadau	zXh	8
gwrthwynebu	B3LA	q
gwrthwynebwr	EUP	2
gwrthwynebwyr	RPI	6
gwrych	BJ/p	u
gwrychoedd	BS7y	v
gwrychyn	BKKl	p
gwrychynnau	BTCn	+
gwryd	BZi9	j
gwrymio	B3Lq	j
gwryw	BKAX	i
gwrywaidd	BKA5	i
gwthio	B3MN	j
gwybed	T9Z	u
gwybedyn	Gv2	q
gwybeta	B3Mw	s
gwybod	Bj9U	j
gwybodaeth	zad	1
gwybodaethau	zZS	BL
gwybodus	fwp	m
gwybyddol	LBn	q
gwybyddus	LC0	m
gwych	fxP	l
gwyddbwyll	Gwg	t
gwyddbwyllion	T+H	v
gwyddeleg	BVkh	BP
gwyddoniadur	EVF	/
gwyddoniaduron	RQC	BH
gwyddoniaeth	BKBb	1
gwyddonol	fx0	r
gwyddonwyr	zcK	1
gwyddonydd	zbS	4
gwyddor	BKCQ	2
gwyddor	GxN	q
gwyddorau	BS8h	8
gwyddorau	T+2	s
gwyddori	B3Nc	r
gwydnhau	B3OH	k
gwydr	zds	p
gwydrau	zc/	t
gwydro	B3Or	g
gwyliau	BS9d	z
gwyliau	zeV	q
gwyliedydd	Gyo	y
gwyliedyddion	UAb	0
gwylio	B3PL	g
gwyliwr	zgQ	p
gwyllt	fyf	b
gwylltio	B3Pr	w
gwylwyr	zfk	s
gwymon	BKD0	o
gwymonydd	BS+Q	6
gwyneb	EWE	k
gwynebau	RRJ	w
gwyngalchu	B3Qb	p
gwynlasu	B3RE	t
gwynnu	B3Rx	g
gwynt	zhi	k
gwyntio	B3SR	i
gwyntoedd	zg5	p
gwyntyllu	B3Sz	p
gwyrdd	fy6	j
gwyrddlas	LCR	j
gwyrddu	B3Tc	q
gwyrgamu	B3UG	j
gwyriad	EXJ	q
gwyriad safonol	HZQ	BH
gwyriadau	RSt	x
gwyro	B3Up	e
gwysio	B3VH	k
gwystlo	B3Vr	i
gwystno	B3WN	l
gwŷr	NYz	s
gwŷr	NZf	u
gyda	fzd	b
gyda synnwyr trannoeth	BOrL	5
gydag	BCn+	z
gydai gilydd	Kwj	1
gydbenodiad	BKEc	2
gydbenodiadau	BS/K	+
gymnasteg	BKGE	4
gyn i	BDDj	n
gyn ti	BDAl	w
gynni hi	BDGR	s
gynno fe	BC+n	t
gynno fo	BDHw	y
gynnoch	BCVB	j
gynnoch chi	BDCA	v
gynnon nhw	BDE2	o
gynnon ni	BC/7	q
gynt	BOb5	t
gyrfa	zi0	j
gyrfaoedd	ziG	u
gyrfaol	BKG8	o
gyriannau	Nl7	5
gyriant	BEH	r
gyrru	B3Wy	d
gyrrwr	zkF	k
gyrrydd	BEy	o
gyrwyr	zjX	u
gyryddion	Nm0	4
gywyo	B3XP	f
gêm	xKv	g
gêr	EBL	f
gêrs	Q5B	n
gŵr	4+	e
gŵr	5c	i
gŵydd	BbVk	v
gŵyl	BKDG	u
gŵyl	ze/	l
hacio	B3Xu	e
hadu	B3YM	d
haearn	BASQ	z
haearnach	jp3	t
haeddu	B3Yp	g
haen	zlP	j
haenau	zkp	m
haenellu	B3ZJ	h
haenlun	VlA	BE
haenluniau	ZWE	BN
haenu	B3Zq	b
haeru	B3aF	f
haf	BZjg	h
hafal	LKc	d
hafaliad	Ejg	p
hafaliad llinol	BaKf	BE
hafaliadau	RfH	8
hafaliadau llinol	BfP/	BJ
hafalnod	BWiK	3
hafalnodau	BWjB	4
hafalochrog	BZkB	BA
hafalu	B3ak	g
hafan	V1H	0
hafanau	Zm7	/
hafau	BezD	l
hagru	B3br	h
hagráu	B3bE	n
haint	zzx	p
haldian	B3cM	g
haldio	B3cs	e
halen	BV23	g
halian	B3dK	d
halio	B3dn	b
hallt	BV3X	a
halltu	B3eC	c
halogi	B3ee	d
hambwrdd	EkJ	m
hambygio	B3e7	e
hambyrddau	RgD	y
hamdden	zmn	l
hamddena	B3fZ	l
hamddenau	zly	1
hamddenol	fz4	l
haneri	BZlB	t
haneru	B3f+	d
hanes	ElS	h
hanes	Ha6	j
hanesion	Rhl	r
haneswr	zn6	p
haneswyr	znM	u
hanesydd	zpU	s
hanesyddion	zoj	x
hanesyddol	f0d	l
hanfod	BPsA	u
hanfodion	BKHk	x
hanfodol	f1C	n
hanner	BWj5	n
hanner cant	BbCt	w
hanner cylch	BZlu	x
hanner cylchoedd	Bezo	BT
hanner troad	BclW	y
hannerawtomatig	BJhU	w
hanu	B3gb	i
hap	BOzm	s
hapau	BVHV	s
hapchwarae	B3g9	m
hapchwarae	BZmf	v
hapchwaraeon	Be07	BC
hapddalwr	BJiE	7
hapddalwyr	BSsD	0
hapddewis	BZnO	4
hapddewis	Be19	0
hapfasnachu	B3hj	o
hapgyrchu	B3iL	p
haprif	BZoq	z
haprifau	Be3Z	8
hapus	f1p	k
harbwr	zqw	p
harbwrs	zqA	w
harddu	B3i0	e
harmonig	LMf	m
harneisio	B3jS	m
hau	B3j4	h
haul	zr9	f
hawdd	LNF	a
hawl	ztE	f
hawlfraint	zuU	p
hawlfreintiau	ztj	x
hawliad	zvu	p
hawliadau	zu9	x
hawliau	zsc	o
hawlio	B3kZ	h
hawliwr	BKIV	t
hawlrwym	BKJC	3
hawlrwymau	BTBs	7
hawlwyr	BTBB	r
haws	f2N	g
heb	LK5	Z
heb os nac onibai	L6Y	z
heb siw na miw	iYG	1
hebddi	BJi/	0
hebddo	LLS	k
hebddoch	BCVk	s
hebddynt	LL2	p
heblaw	f2t	e
hebrwng	B3k6	f
heclo	B3lZ	i
hecs	H3T	X
hecsadegol	KQU	x
hecsagon	BZpd	r
hecsagonau	Be4V	z
hecsagram	BZqI	v
hecsagramau	Be5I	y
hecsdeils	RiQ	r
hecsdeilsen	Elz	y
hecsomino	BZq3	q
hecsominos	Be56	v
hectar	zxG	m
hectarau	zwX	v
hecterw	zyY	m
hecterwau	zxs	s
hecto	LNf	c
hectogram	BZrh	q
hectogramau	Be6p	x
hectolitr	BZsL	y
hectolitrau	Be7a	3
hectometr	BZs9	v
hectometrau	Be8R	3
heddiw	f3L	b
heddlu	BJjz	t
heddlu	f3m	l
heddluoedd	BSs3	0
heddwch	f4L	m
heddychlon	LN7	p
heddychu	B3l7	d
hedfan	B3mY	c
hedo	B3m0	b
hefyd	LOk	c
heglu	B3nP	b
heibio	f4x	e
heicio	B3nq	f
heidio	B3oJ	d
heigio	B3om	d
heini	f5P	c
heintiau	z0a	t
heintio	B3pD	l
heintus	f5r	l
heislanu	B3po	n
hel	B3qP	e
hel dail	BPRb	BG
hela	B3qt	d
helaeth	f6Q	f
helaethach	BKJ5	s
helaethiad	BZts	2
helaethiadau	Be9I	6
helaethrwydd	BPoz	x
helaethu	B3rK	k
helmu	B3ru	s
helpio	B3sa	Z
helpu	B3sz	Z
helynt	z1z	t
helyntion	z1H	s
hemio	B3tM	f
hen	BB2/	V
henaidd	BObH	y
hencian	B3tr	d
hendrefu	B3uI	g
heneiddio	B3uo	e
heno	f6v	g
hepgor	B3vG	c
hepgor	z3X	v
hepgoriad	BKLO	v
hepgoriadau	BTDl	8
hepgorion	z2g	3
hepian	B3vi	g
heptagon	BZui	t
heptagonau	Be+C	1
her	z40	m
hercian	B3wC	i
hercio	B3wk	k
herfeiddio	B3xI	i
herian	B3xq	d
heriau	z4G	u
herio	B3yH	h
heriol	f7P	m
herwgipio	B3yo	i
herwhela	B3zK	m
hesbio	B3zw	b
heu	B30L	Y
heuliau	zrZ	k
heulo	B30j	j
heulwen	Hbd	q
heuru	B31G	j
heyrn	z5a	s
hi	BDJt	X
hicio	B31p	c
hidio	B32F	Z
hidl	EnK	i
hidlau	Rjm	s
hidlen	Eml	l
hidlenni	Ri7	r
hidlo	B32e	e
hidlo drwy	BMke	BH
hidroleiddio	B328	o
hierarchaeth	BTW	0
hierarchaethau	N3t	7
hierarchaidd	IxC	w
hiffio	B33k	k
hifflo	B34I	d
hifio	B34l	c
hiliaeth	BJkg	n
hiliol	BDjn	h
hindreulio	B35B	v
hindro	B35w	f
hinoni	B36P	u
hinsawdd	z6s	n
hinsoddau	z6G	m
hinsoddi	B369	m
hir	BVa/	Z
hirach	f71	d
hiraeth	z8C	p
hiraethau	z7T	v
hiraethu	B37j	p
hiraf	Iwk	e
hirbarhau	B38M	i
hirdymor	f8S	q
hirfaith	BKL9	o
hirgrwn	BXFo	g
hirgylch	BZvP	s
hirgylchau	Be+3	0
hirhoedlog	BKMl	r
hirsefydledig	BJlH	x
hirsefydlog	BJl4	u
hirsgwar	Ens	p
hirsgwar	LPA	j
hirsgwarau	RkS	t
hisian	B38u	e
hithau	f88	g
hiwmor	z9Y	o
hiwmorau	z8r	t
hobelu	B39M	j
hocedu	B39v	i
hoelio	B3+R	g
hoenynnu	B3+x	g
hoetian	B3/R	k
hoff	BB3U	f
hoff	IvQ	d
hoffeicon	BFa	t
hoffeiconau	Nns	w
hoffi	B3/1	e
hoffter	BSr	r
hoffterau	N2z	6
hofio	B4AT	c
hofran	B4Av	i
hogi	B4BR	c
hogiau	z+k	j
hogyn	z+A	k
holi	B4Bt	Z
holiadur	z/5	w
holiaduron	z/H	y
holl	Hy+	X
hollol	f9c	m
hollt	BHhj	8
hollt	BHjy	BF
holltau	BRuM	BM
hollti	B4CG	e
hollti blew	BPQf	8
holwyddori	B4Ck	l
hon	BCaa	c
honcio	B4DJ	f
honedig	f+C	i
hongian	B4Do	c
honiad	0Be	u
honiadau	0Ap	1
honna	BCba	g
honni	B4EE	d
honno	BCa2	k
hostel	BJmm	z
hosteli	BStr	1
hoyw	BATD	q
hoywi	B4Eh	o
hualu	B4FJ	e
hud	LPj	Z
huddo	B4Fn	d
hudladrata	B4GE	j
hudo	B4Gn	g
hufen	BDKn	f
hufennau	BDKE	j
hufennu	B4HH	e
hulio	B4Hl	k
hunain	Ivt	h
hunan	f+k	c
hunanachosedig	BKO3	BC
hunanasesu	B4IJ	t
hunanbarch	BKOB	2
hunanddewis	B4I2	p
hunanfoddhaus	BPJw	w
hunangadw	Bh19	w
hunangychwyn	Bh3Q	r
hunangyfeirio	B4Jf	t
hunangyflogedig	BKNQ	x
hunangynhaliol	BKP5	y
hunanholi	B4KM	p
hunaniaeth genedlaethol	BKQr	BQ
hunanladdiad	BKR7	3
hunanweithredu	BjAg	x
hunanymwadu	B4K1	y
hunllef	Gs1	q
hunllefau	T52	u
huno	B4Ln	k
hurbwrcas	BZv7	z
hurbwrcasau	Be/r	7
hurio	B4ML	o
hurtio	B4Mz	u
hwn	BCWQ	f
hwnna	BCWv	l
hwnnw	BCXU	g
hwnt	f/A	h
hwpio	B4Nh	m
hwpo	B4OH	a
hwrio	B4Oh	e
hwsmona	B4O/	j
hwtian	B4Pi	c
hwtio	B4P+	a
hwy	BZxS	i
hwy	IwO	W
hwyaf	BZx0	h
hwyhau	B4QY	g
hwyl	HcH	d
hwylfyrddio	B4Q4	o
hwylio	B4Rg	c
hwylus	f/h	j
hwyluso	B4R8	j
hwyluso	BjJW	o
hwyr	LP8	Y
hwyrach	LQU	e
hwyrach	LQy	g
hwyraf	BZwu	k
hwyred	BCX0	g
hwyrhau	B4Sf	i
hwythau	XiO	p
hy	Bbyj	5
hy	gAE	W
hyblyg	gAa	h
hyblygrwydd	gA7	s
hybu	B4TB	k
hyd	/Gk	h
hyd y bo modd	BbHW	y
hyd yn hyn	BPq8	BE
hydau	0CM	q
hyder	0Di	n
hyderoedd	0C2	s
hyderu	B4Tl	l
hyderus	gBn	k
hydoedd	0EJ	s
hydref	0Fc	n
hydref	BIvg	l
hydrefau	0E1	n
hyfforddai	0G0	q
hyfforddedig	BKSy	BC
hyfforddeion	0GD	x
hyfforddi	B4UK	l
hyfforddiad	EoV	w
hyfforddiadau	Rk/	v
hyfforddiadol	LRS	0
hyfforddiant	gCL	0
hyfforddwr	0IU	u
hyfforddwyr	0He	2
hyfryd	gC/	l
hyfrydu	B4Uv	i
hyfrydwch	BbII	q
hyfyw	BKT0	o
hyfywedd	BKUc	1
hygrededd	BKVR	s
hygyrch	gDk	p
hygyrchedd	gEN	w
hylaw	BKV9	l
hylendid	gE9	p
hylenydd	BLx0	2
hylenyddion	BT2o	v
hylif	BWkg	o
hylifau	BWlI	o
hylifo	B4VR	g
hylifol	LSG	j
hyll	gFm	g
hymian	B4Vx	d
hymynnu	B4WO	i
hyn	gGG	k
hynaf	gGq	a
hynafol	gHE	d
hynny	gHh	h
hynny yw	Bbzc	5
hynod	gIC	m
hynodi	B4Ww	m
hynt	BAUe	q
hyntoedd	BATt	x
hyperbolig	Hxi	w
hypergeometrig	LTs	BB
hypergyswllt	Epk	5
hypergysylltau	RmX	9
hypnoteiddio	B4XW	q
hyrddio	B4YA	c
hyrddu	B4Yc	e
hyrwyddiad	BKWi	y
hyrwyddiadau	BTEh	w
hyrwyddo	B4Y6	n
hyrwyddwr	BKXU	p
hyrwyddwyr	BTFR	x
hysbyddu	B4Zh	t
hysbys	gIo	d
hysbyseb	0J5	y
hysbysebion	0JC	3
hysbysebu	B4aO	m
hysbysebwr	ErO	2
hysbysebwyr	RoG	9
hysbysedig	LUt	v
hysbysiad	0Lm	x
hysbysiad	Eqd	x
hysbysiadau	0Kr	7
hysbysiadau	RnU	y
hysbyslen	BKX9	w
hysbyslenni	BTGC	2
hysbysrwydd	BKYt	/
hysbysu	B4a0	i
hysbysu	Biel	i
hysbysydd	EsE	u
hysbysyddion	RpD	5
hysian	B4bW	i
hytrach	gJF	f
hyweddu	B4b4	j
hŷn	LSp	a
i	BB6K	T
i	BCqr	Q
i chi	BCha	Y
i fi	BCmA	j
i fyny	KrO	c
i lawr	BZyV	g
i mewn	H7L	h
i mi	BCku	q
i ni	BCiz	k
i raddau helaeth	BNe0	8
i ti	BClY	o
iaau	0MX	s
iach	gJk	e
iachach	BKZs	n
iachus	BKaT	o
iacháu	B4cb	m
iaith	0OP	j
iaith arwyddion	BIIv	9
iaith lafar	BO8a	z
iasu	B4dB	f
iau	BKbk	k
iau	BKcI	n
iau	BOmS	l
iau	LVc	Z
iawn	LzG	X
iawn	gKC	a
iawndal	BBYv	4
iawndaliad	BKcv	z
iawndaliadau	BTG4	BG
iawndaloedd	BBZn	BE
icosahedron	BZ5M	x
icosahedronau	BfDL	9
iddew	BVlw	d
iddewes	BVmN	p
iddewesau	BWEK	o
iddewiaeth	BVnZ	w
iddewig	BVm2	j
iddewon	BWDe	s
iddi	gKc	b
iddo	gK3	a
iddo fe	BCjX	w
iddo fo	BCkH	n
iddyn nhw	BChy	e
iddynt	gLR	f
iddynt hwy	BCiQ	j
ideolegol	BKdi	j
ie	gLw	X
iechyd	0Qi	j
iechydau	0P2	s
ieir	0Oy	m
ieithoedd	0Nl	q
ieithoedd arwyddion	BSIU	9
ieithyddol	gMH	o
iengeiddio	B4dg	m
ieuainc	BKer	u
ieuanc	gMv	a
ieuau	BVDz	s
ieuenctid	gNJ	t
ieuengaf	BKeF	m
ieuo	B4eG	e
ifainc	BBqa	h
ifanc	gN2	d
igamogamu	B4ek	j
igian	B4fH	e
ildio	B4fl	j
imperial	BZ59	t
impetws	BKfZ	q
impio	B4gI	c
imwneiddio	B4gk	t
incwm	0Rv	l
incwm	BZ6q	7
incymau	0RF	q
incymau	BfEI	u
indemniad	BKg2	t
indemniad	BKgD	z
indemniadau	BTH+	BA
indemnio	BjKk	j
indoewropeg	BZzd	5
injan	BAV9	t
injans	BAVI	1
innau	gOT	j
inni	gO2	b
inswleiddio	B4hR	m
integredig	gPR	m
integreiddio	BifH	w
integrol	LWZ	n
ionawr	BItk	p
ir	BOxQ	f
ir chwith	BYsD	3
ir dde	BYs6	n
ireiddio	B4h3	h
iro	B4iY	b
is	BKhj	d
isadeiledd	gP3	v
isadran	BKiA	BB
isadrannau	BTI+	BH
isaf	BWnL	c
isafbwynt	BZ9b	r
isafbwyntiau	BfG4	5
isafrif	V17	0
isafrifau	Zn6	/
isafswm	0SU	p
isafsymiau	0Tx	q
isbanel	BKjB	m
isbanelau	BTKF	2
isbaragraff	0Ub	BB
isbaragraffau	0S9	0
isbwyllgor	BKjn	0
isbwyllgorau	BTK7	/
isel	gQm	l
iselder	BAWq	2
iselderau	0Vc	z
iselhau	B4iz	o
iselu	B4jb	n
isgilio	B4kC	v
isgoch	LXA	h
isgyfeiriadur	Esy	BC
isgyfeiriadur	Rp8	+
isio	gRL	p
islaw	gR0	c
islythrennau	Rq6	BB
islythrennol	Xi3	w
islythrennu	Bigo	v
islythyren	Et0	8
isod	gSQ	b
isomedrig	BZ+G	k
isosgeles	BZ+q	u
isosod	B4kx	d
isradd	V3h	t
israddau	Zps	2
israddedig	BHw6	1
israddedig	BHxv	5
israddedigion	BR3K	8
israddio	BihX	m
isrannu	B4lO	l
isset	BZ/Y	x
issetiau	BfHx	r
isymwybodol	BPpk	v
italig	Xkb	0
iteriad	uO	q
iteriadau	NL9	4
iteru	Bg4I	BH
iterus	H5f	j
iti	gSr	b
iw	gTG	l
iwerddon	Hck	r
iâ	0ND	i
iâr	0PY	e
jacio	B4lz	c
jamio	B4mP	f
jar	BKkb	j
jargon	Bc3v	m
jariau	BTL6	u
jigso	GKv	m
jigsos	TV5	p
jocan	B4mu	e
jochio	B4nM	g
jocian	B4ns	d
jwg	BaAJ	i
jygiau	BfIc	u
label	0W7	q
labeli	0WP	s
labelu	B4oJ	e
labordai	0YP	u
labordy	0Xl	q
labro	B4on	e
lafant	HdP	o
lambastio	B4pF	l
lamineiddio	B4pq	n
lamp	Euw	d
lampau	M+f	s
lanlwythiadau	Rr7	9
lanlwytho	Biiw	t
lanlywthiad	EvN	u
lansiad	BKk+	v
lansiadau	BTMo	x
lansio	B4qR	f
lapio	B4qw	a
larwm	Ev7	h
larymau	Rs4	w
lasio	B4rK	e
lawnsio	BjhI	o
lawrlwythiad	Ewc	z
lawrlwythiadau	Rto	8
lawrlwytho	Bijd	u
ledio	B4ro	l
ledled	gTr	i
lefeinio	B4sN	g
lefel	0Zk	l
lefelau	0Y9	n
lefelu	B4st	c
leicio	B4tJ	e
lein	0bT	j
leiniau	0aJ	n
leinio	B4tn	d
leins	0aw	j
lembyd	LXh	g
lercio	B4uE	h
lesio	B4ul	e
licio	B4vD	d
litr	0ca	g
litrau	0b2	k
llabyddio	B4vg	i
llachar	gUn	g
llachio	B4wj	e
llacio	B4xB	f
llacáu	B4wC	h
lladd	B4xg	f
lladin	LYB	g
lladmerydd	BKn8	5
lladmeryddion	BTOT	7
lladrata	B4x/	d
lladroni	B4yc	i
llaes	BO19	g
llaesu	B4y+	f
llaeth	0dg	g
llaethau	0c6	m
llaethu	B4zd	h
llafar	BAXg	u
llafarganu	B4z+	i
llafariad	BJxg	q
llafariaid	BS3e	x
llafnu	B40g	g
llafur	0es	l
llafuriau	0eA	s
llafurio	B41A	i
llai	BaDa	h
llai	LYh	Y
llai na	BaC0	m
llain	BKqm	v
llais	Eyd	h
llais yn llefain yn y diffeithwch	BKo1	Bx
llaith	LY5	c
llall	gVH	c
llam	Ezq	d
llamau	Rxp	n
llamsachu	B41i	j
llamu	B42F	i
llanast	Hd3	j
llanastr	E0H	l
llanastru	B42n	i
llanc	0gA	p
llanciau	0fR	v
llanerchu	B43J	q
llanw	0hY	o
llanw	B43z	g
llanwau	0gp	v
llarieiddio	B44T	k
llarpio	B443	i
llath	BaEf	v
llathau	BfLo	2
llathen	V5H	y
llathenni	Zrk	7
llathru	B45Z	h
llau	RyQ	n
llaw	u8F	k
llawcio	B456	e
llawdio	B46Y	w
llawdriniaeth	BKrV	Bf
llawdriniaethau	BTP+	BB
llawen	gVj	f
llawenhau	B47I	j
llawenychu	B47r	n
llawenydd	gWC	n
llawer	gWp	d
llawfeddygol	BKs0	l
llawiadur	V55	7
llawiadur	V60	6
llawiaduron	Zsf	BE
llawiaduron	Ztj	9
llawlyfr	0iA	p
llawlyfrau	0ip	q
llawn	gXG	g
llawnach	BaFO	h
llawnaf	BaFv	e
llawnodi	B48S	h
llawnwerth	W3L	2
llawr	E1R	h
llawr	E1y	i
llawysgrif	0kF	y
llawysgrifau	0jT	y
lle	0wL	u
lle degol	BaGN	3
llechfeddiannu	B48z	v
llechu	B49i	h
llechweddu	B4+D	p
lled	0lp	o
lled	BB4P	a
lled	BaHE	k
lled breichiau	BaHo	u
lledaenu	B4/V	x
lledau	0mR	n
lledau	BfNi	v
lleddfu	B5AG	j
lledferwi	B5Ap	o
lledorwedd	B4+s	p
lledorwedd	B5BR	s
lledr	BVvs	v
lledrau	BWGA	q
lledrau y gwefusau	BVwb	9
lledu	B5B9	i
lledwyro	B5Cf	k
llefain	B5DD	h
llefaru	B5Dk	k
llefarwr	0ng	p
llefarwyr	0m4	o
llefarydd	0o5	r
llefaryddion	0oJ	w
lleferoedd	BAYO	9
lleferydd	W4B	3
llefydd	0k3	y
lleia	BWnn	p
lleia	BWoQ	z
lleiaf	BaD7	k
lleiaf	LZV	e
lleiafol	LaZ	r
lleiafrif	/F8	o
lleiafrifau	0pk	3
lleiafrifol	gXm	m
lleiafswm	0rJ	z
lleiafsymiau	0qb	u
lleibio	B5EI	g
lleied	BCYU	i
lleihad	gYM	m
lleihau	B5Eo	l
lleihau	Bilj	p
lleihau	BimM	l
lleihau	BinX	s
lleill	gYy	p
lleinasio	B5FN	p
lleiniau	BTPO	w
lleisiau	RwF	w
lleisio	B5F2	g
llem	BatL	m
llemain	B5GW	g
llen	0sr	m
llennau	BTS4	u
llenni	0r8	v
llenor	0t/	n
llenora	B5G2	o
llenorion	0tR	u
llenwi	B5He	k
llenydda	B5IC	5
llenyddiaeth	0vc	v
llenyddiaethau	0um	2
llenyddol	gZb	l
llenyddoldeb	BOjZ	1
lleoedd	0w5	u
lleoedd degol	BfMe	BE
lleol	gaA	d
lleoleiddio	Bik3	s
lleoli	B5I7	g
lleoliad	0yQ	s
lleoliadau	0xn	p
lleolnod	Fco	p
lleolnodau	SeL	2
lleolydd	ExP	r
lleolyddion	Ruk	t
llercian	B5Jb	g
lles	BAb1	z
llesau	BAZL	2
llesgu	B5Ke	j
llesgáu	B5J7	j
llesio	B5LB	p
llesion	BAaB	8
llesmeirio	B5Lq	j
llesoedd	BAa9	4
llesol	BKwo	k
llesteirio	B5MN	l
llestrio	B5My	t
llestru	B5Nf	s
llesu	B5OL	t
lletach	LbE	e
lletaf	BaIW	f
lletemu	B5O4	l
llethol	gad	o
llethr	0zt	m
llethrau	0y8	x
llethu	B5Pd	i
lletraws	E2U	k
lletraws	Lbi	l
llety	00+	l
lletya	B5P/	f
lletyau	00T	r
lleuad	Ex6	j
lleuadau	RvR	0
lleuadol	LZz	m
lleuen	E0s	l
llew	BKxM	f
llewod	BTTm	y
llewychu	B5Qe	l
llewygu	B5RD	h
llewyrchu	B5Rk	n
llewyrchus	gbF	n
lleyg	BAco	v
lliain	E24	j
lliain	LcH	d
lliaws	BKxr	w
llidio	B5SL	g
llieiniau	Rzc	l
llif	02N	h
llif	BBt8	u
llif	BKyb	e
llifanu	B5Sr	h
llifeirio	B5TM	l
llifianu	B5Tx	j
llifiau	BBs+	+
llifio	B5UU	d
llifo	B5Ux	d
llifo	B5VO	g
llifoedd	BTUY	2
llifogydd	01j	q
llifoleuo	B5Vu	o
llifsiartio	BikL	s
llinborthi	BiMk	m
llinborthiad	DZ7	z
llinborthiadau	QRM	7
llindagu	B5WW	k
llinell	03b	i
llinell ddrych	BZCd	8
llinell doredig	BaI1	8
llinell glo	BPcb	BK
llinell grom	BaJx	u
llinellau	02u	t
llinellau clo	BVOd	BX
llinellau crwm	BfPJ	2
llinellau drych	BeZI	BB
llinellau toredig	BfOR	4
llinellausylfaen	BTNZ	6
llinellsylfaen	BKlt	t
llinellu	B5W6	k
lliniarol	gbs	m
lliniaru	CFuY	o
llinol	Lck	g
llinyn	04q	n
llinynnau	039	t
llinynnu	B5Xe	h
llipa	LdE	c
llithio	B5X/	p
llithro	B5Yo	k
llithrydd	E3b	s
llithryddion	R0B	t
lliw	058	k
lliwgar	gcS	n
lliwiau	05R	r
lliwio	B5ZM	i
lloches	BKy5	l
llochesau	BTVO	p
llochesu	B5Zu	l
llochi	B5aT	h
llocio	B5a0	m
llodi	B5ba	o
lloegr	BKze	k
lloeren	E4H	r
lloerenni	R0u	w
lloesi	B5cC	m
llofelu	B5co	g
lloffa	B5dI	g
llofft	06g	n
llofftydd	07H	n
llofnod	/HF	t
llofnodau	07u	r
llofnodi	B5do	f
llofnodwr	E4y	t
llofnodwyr	R1e	x
llofruddio	B5eH	k
llog	V7u	2
llogau	Zug	9
llogi	B5er	e
llond	gc5	p
llong	09B	n
llongau	08Z	o
llongyfarch	B5fJ	p
llongyfarchiad	BK0C	2
llongyfarchiadau	BTV3	5
llonni	B5fy	k
llonydd	gdi	g
llonyddu	B5gW	o
llori	B5g+	h
lloriau	Ry3	l
llorio	B5hf	i
llorwedd	E5f	t
llorweddau	R2P	z
llorweddol	Ldg	t
llosg	geC	b
llosgi	B5iB	d
llowcio	B5ie	j
llu	BAeE	p
lluchedu	B5jB	f
lluchio	B5jg	f
lluddedu	B5j/	g
lluddias	B5kf	j
lluddio	B5lC	k
llueddu	B5lm	l
llumanu	B5mL	i
llun	0+R	i
llundain	BK04	o
llungopi	BK1g	z
llungopïau	BTWw	v
lluniad	C3I	p
lluniad	FA5	p
lluniadau	Ppi	p
lluniadau	R+q	0
lluniadu	B5mt	l
lluniadu	BiB1	f
lluniadu wrth raddfa	BZb4	3
lluniaethu	B5nS	n
lluniau	09o	p
llunio	B5n5	g
llunio	BheL	v
llunio	Bj2A	u
llunydd	E6M	r
llunyddion	R3C	y
lluoedd	BAdX	t
lluosi	B5oZ	i
lluosnomial	E63	3
lluosnomialau	R30	4
lluosog	ged	h
lluosogi	B5o7	o
lluosogol	LeN	z
lluosol	LfA	l
lluosrif	V8k	5
lluosrif cyffredin lleiaf	BaMR	Bc
lluosrifau	Zvd	BA
lluosrifau cyffredin lleiaf	BfRI	BP
lluoswm	V9d	7
lluosymiau	Zwd	BC
llurgunio	B5pj	q
llusa	B5qN	r
llusgadwy	Lfl	s
llusgo	B5q4	f
llutrodi	B5rX	p
lluwchio	B5sA	u
lluyddu	B5su	i
llwch	ge+	h
llwfrhau	B5tQ	m
llwgr	E7u	n
llwgr	LgR	e
llwgr	XlP	0
llwgrwobrwyo	B5t2	o
llwgu	B5ue	t
llwy	0/b	h
llwya	B5vL	f
llwyaid	E8V	p
llwyau	0+z	o
llwybr	1Ai	g
llwybrau	0/8	m
llwybreiddio	B5vq	m
llwybro	B5wQ	p
llwyd	gff	g
llwyddiannau	1BC	w
llwyddiannus	gf/	n
llwyddiant	1By	p
llwyddo	B5w5	i
llwydfelyn	Lgv	n
llwydnetig	LhW	s
llwydo	B5xb	k
llwydrewi	B5x/	2
llwyeidiau	R5c	3
llwyfan	BK2T	x
llwyfannaidd	BK3p	l
llwyfannau	BTXf	3
llwyfannol	BK3E	l
llwyfannu	B5y1	i
llwyr	ggm	e
llwyrlanhau	B5zX	v
llwyrymatal	B50G	t
llwyrymwrthod	B50z	z
llwyth	1DG	m
llwyth	1EU	j
llwythau	1Ds	o
llwythedig	LiC	q
llwythi	1Cb	r
llwytho	B51m	h
llwythog	BPl0	l
llwythydd	E8+	r
llwythyddion	R6T	u
llychwino	B52H	m
llydan	BDYU	u
llydan	ghE	j
llydnu	B52t	k
llyffetheirio	B53R	x
llyfn	ghn	c
llyfnhau	B54C	h
llyfnu	B54j	j
llyfr	1Fe	h
llyfr siec	BcKT	q
llyfrau	1E3	n
llyfrau siec	Bgdm	7
llyfrgell	BBgI	z
llyfrgelloedd	BBg7	8
llyfrgellwr	BK4O	x
llyfrgellwyr	BTYW	z
llyfrgellydd	BK4/	0
llyfru	B55t	o
llyfrwerthu	B56V	q
llyfrwerthwr	BIwF	u
llyfrwerthwyr	BSWR	1
llyfryddiaeth	BbfI	8
llyfryddiaeth ddethol	BbgE	BK
llyfryddiaethau	Bf+1	8
llyfryddiaethau dethol	Bf/x	BH
llyfryddol	BK5z	x
llyfryn	1Gr	l
llyfrynnau	1F/	s
llyfrïo	B55G	n
llyfu	B56/	c
llygad	1H5	j
llygad y dydd	Bbvd	1
llygaddynnu	B57b	r
llygadrythu	B58G	j
llygadu	B58p	j
llygaid	1HQ	p
llygaid y dydd	BgIF	y
llygod	1JE	j
llygoden	1Ic	o
llygota	B59M	j
llygrau	R4s	w
llygredd	/IU	r
llygreddau	/I/	0
llygredig	/Hy	i
llygrio	B59v	q
llygru	B5+Z	p
llygru	BioD	i
llym	BW7V	d
llymder	E9p	p
llymderau	R7B	y
llymeidio	B5/C	k
llymeitian	B5/m	i
llymeitio	B6AI	h
llymhau	B6Ap	i
llyn	BK6k	p
llyncu	B6BL	l
llynedd	giD	i
llynnoedd	BTZJ	2
llyo	B6Bw	g
llys	1KT	j
llysdaid	BK7N	3
llysdeidiau	BTZ/	/
llysenwi	B6CQ	o
llysiau	1Lk	p
llysieuyn	1K2	u
llysnain	BK8E	v
llysneiniau	BTa+	6
llysoedd	1Jn	s
llysriant	BK8z	0
llysrieni	BTb4	3
llystyfiannau	1NA	y
llystyfiant	1MN	z
llythrdai	BfSX	BB
llythrdy	BaNt	3
llythrennau	BAfo	4
llythrennedd	gil	r
llythrennol	gjQ	o
llythrennu	B6C4	q
llythrenw	E+S	t
llythrenwau	R7z	z
llythyr	BAhf	+
llythyr cysur	BNvL	3
llythyra	B6Di	l
llythyrau	BAgg	/
llythyrau cysur	BUxt	BN
llythyren	BAet	7
llythyru	B6EH	j
llyu	B6Eq	e
llywio	B6FI	j
llywiwr	E+/	q
llywodraeth	1Oo	4
llywodraethau	1Ny	2
llywodraethol	gj4	w
llywodraethu	B6Fr	n
llywodraethwr	1Qc	1
llywodraethwyr	1Pg	8
llywydd	BK9n	v
llywyddion	BTcv	x
llywyddu	B6GS	l
llywyr	R8m	t
llên	BKv6	u
lobïo	Bjhw	q
locws	BaCP	l
locysau	BfK7	t
loetran	B6G3	e
logarithm	E/p	v
logarithmau	R9T	0
logarithmig	Lis	0
logistaidd	BKuY	w
logo	FAY	h
logos	R+H	j
lolian	B6HV	f
loncian	B6H0	o
lordio	B6Ic	j
losen	V+Y	3
losin	Zxf	+
losin llygad	Hea	4
loteri	1SH	y
loteris	1RR	2
lotri	BKvI	y
lotris	BTSG	y
lwc	HfS	c
lwcus	gUN	a
lwfans	1Tm	p
lwfansau	1S5	t
mab	1U1	f
mabwysiadol	BK+W	s
mabwysiadu	B6I/	j
mabwysiedig	BK/C	m
machlud	B6Ji	i
macsu	B6KE	c
maddau	B6Kg	g
madru	B6LA	n
mae ganddo feddwl mawr o 	BPLf	BJ
mae taer angen arno i wneud hyn	BNXn	Bg
maeddu	B6Ln	i
maelio	B6MJ	d
maen	1V6	g
maeneiddio	B6Mm	m
maentumio	B6NM	h
maer	1W+	g
maes	1YE	g
maesu	B6Nt	e
maeth	1ZR	n
maethion	1Yk	t
maethlon	BK/o	v
maethu	B6OL	e
magenta	Ljg	i
maglu	B6Op	k
magneteg	Hfu	u
magneteiddio	B6PN	t
magnetig	LkC	n
magu	B6P6	b
magwyro	B6QV	f
mai	BDTG	n
mai dyma	BZ1r	l
maint	1v2	f
maintioli	BLAX	z
maldodi	B6Q0	f
malu	B6RT	n
malurio	B6R6	v
mam	BLBK	l
mamau	BTdg	w
mamiaith	1au	t
mamieithoedd	1Z4	2
mamogi	B6Sp	h
mamolaeth	gko	x
man	FCS	d
man clymu	BQZ	y
man cychwyn	BDvR	/
mandadu	B6TK	j
mannau	SAO	s
mannau clymu	N0S	6
mannau cychwyn	BQDo	BA
manoli	Biol	h
mantais	1cQ	q
manteisio	B6Tt	g
manteisiol	BLBv	t
manteision	1bb	1
mantellu	B6UN	j
mantol	BLTv	2
mantolen	BLTE	r
mantolenni	BTk6	+
mantoli	B6Uw	j
mantolion	BTl4	BB
manwerth	BLDC	m
manwerthu	Bjia	n
manwerthwr	BLCc	m
manwerthwyr	BTeQ	4
manwl	glZ	s
manwl gywir	BWaq	0
manwl gywirdeb	BaPg	BB
manylach	gmF	s
manylder	W44	2
manyleb	1dv	t
manyleb	BLDo	x
manyleb	Bh+	u
manylebau	1c6	1
manylebau	OHw	z
manylebion	BTfI	5
manylion	1fJ	p
manylu	B6VT	i
manylyn	1ec	t
map	1gW	h
map arolwg ordnans	BaQh	Bb
mapiad	BaR8	o
mapiadau	BfVt	BM
mapiau	1fy	k
mapiau arolwg ordnans	BfUX	BW
mapiedig	Ka+	l
mapio	BiOU	e
mapiwr	FCv	k
mapwyr	SA6	2
marc	FDT	d
marc rhifo	BaSk	1
marchio	B6V1	v
marchnad	1hi	i
marchnadoedd	1g3	r
marchnadymwybodol	BLEZ	2
marchnata	B6Wk	j
marchnerth	HhW	v
marchocáu	B6XH	i
marchogaeth	1jG	v
marchogaeth	B6Xp	q
marchogaethau	1iE	BC
marciau	SBw	k
marcio	B6YT	c
marciwr	FDw	m
marcwyr	SCU	m
marmor	FEW	k
marmorau	SC6	o
marsiandïaeth	BLFP	z
marsiandïo	BjjB	u
marsiandïol	BLGC	6
marsiandïwr	BLG8	2
marsiandïwyr	BTgB	y
martsio	B6Yv	f
marw	B6ZO	c
marw	gmx	Z
marweiddio	B6Zq	r
marwhau	B6aV	g
marwnadu	B6a1	g
marwol	Lkp	d
marwolaeth	1kr	v
marwolaethau	1j1	2
masg	WCp	BA
masgau	Z1P	BL
masgio	B6bV	a
masglu	B6bv	j
masnach	1mb	t
masnachau	1la	BB
masnachfraint	BLHy	BB
masnachol	gnK	m
masnacholeisail	BLIz	BB
masnacholsensitif	BElN	6
masnachu	B6cS	h
mater	1n0	i
materion	1nI	s
materol	gnw	f
math	FE6	g
mathau	SDi	k
mathemateg	goP	y
mathemategol	gpB	s
mathru	B6cz	q
matriciwleiddio	B6dd	t
matrics	FFa	m
matricsau	SEG	s
mawr	LlG	X
mawrhau	B6eK	h
mawrion	BLLZ	t
mawrth	BIuN	t
mawrth	BLKn	y
mawrygu	B6er	k
mecaneiddio	B6f1	1
mecanwaith	1pI	q
mecanweithiau	1oW	y
mecanyddol	gpt	u
medd	B6gq	b
meddal	gqb	o
meddalhau	B6hF	l
meddalu	B6hq	o
meddalwedd	grD	z
meddiannau	1qo	y
meddiannol	Lld	r
meddiannu	B6iS	s
meddiant	1py	2
meddu	B6i+	Z
meddwi	B6jX	l
meddwl	1st	o
meddwl	B6j8	f
meddyg	1ra	n
meddygaeth	/V0	y
meddygfa	BAjY	y
meddygfeydd	BAid	7
meddyginiaeth	BAlS	/
meddyginiaethau	BAkK	BI
meddyginiaethu	B6kb	p
meddygol	gr2	i
meddygon	1sB	s
meddylfryd	BLMG	v
meddyliau	1tV	u
meddyliol	gsY	m
medi	B6lE	b
medi	BIu6	m
medr	1up	m
medrau	1uD	m
medru	B6lf	g
medrus	gs+	k
meflu	B6l/	h
megabeit	FGA	w
megabeitiau	SEy	v
megina	B6mg	z
megis	gti	g
mehefin	BDTt	l
meibion	1UP	m
meiddio	B6nT	d
meidraidd	Lmo	m
meidryddu	B6nw	g
meil	HiF	g
meillion	1vP	n
meillionen	BAmR	BG
meimio	B6oQ	c
meincnod	BLM1	r
meincnodau	BTgz	r
meincnodi	B6os	n
meindio	B6pT	g
meinhau	B6pz	l
meini	1VU	m
meintiau	1wV	p
meintiol	BLUl	p
meintoli	B6qY	k
meinwe	BM97	0
meinwebledd	BUZx	4
meiri	1Wa	k
meirioli	B6q8	l
meirw	BCY2	h
meistr	1xj	o
meistri	1w+	l
meistroli	B6rh	k
meistrolwg	EHt	1
meistrolygon	RA6	8
meithrin	B6sF	k
melin	BLVO	h
melinau	BTm5	n
melltennu	B6sp	v
melltio	B6tY	t
melltithio	B6uF	n
melwlith	Hil	s
melyn	guC	e
melynddu	Xnm	v
melynu	B6us	i
melys	gug	e
melysu	B6vO	k
memoranda	BTng	4
memorandwm	BLWf	s
mendio	B6vy	g
menter	1y4	p
mentergarol	BLVv	w
mentrau	1yL	t
mentro	B6wS	m
mentrus	BLXL	v
menu	B6w4	f
menyn	gu+	j
menyw	FHP	i
menywod	SGJ	v
merch	10L	m
merched	1zh	q
mercher	BaTZ	9
mercheta	B6xX	k
merlota	B6x7	i
merthyru	B6yd	h
merwino	B6y+	c
mesmereiddio	B6za	p
mesur	11Z	i
mesur	Bj2u	i
mesur brest	BaUW	BH
mesur clun	BaVd	w
mesur gwasg	BaWN	8
mesuradwy	BLNg	r
mesurau	10x	o
mesurau brest	BfXr	BE
mesurau clun	BfYv	BL
mesurau gwasg	BfZ6	8
mesuriad	12u	s
mesuriadau	117	z
mesuro	B60D	h
mesurydd	BAoe	6
mesuryddion	BAnX	BH
metadata	HjR	s
metagwybodaeth	Hj9	+
metel	/Fa	i
meteloedd	13a	y
methdaliad	15B	y
methdaliadau	14M	1
methdalu	BipG	m
methdalwrus	BJHQ	w
methedig	LnO	m
methiannau	16m	u
methiant	15z	z
methodoleg	18I	y
methodolegau	17U	0
methu	B60k	f
metr	BAqP	v
metr ciwb	BX56	u
metr sgwâr	BX6o	0
metrau	BApY	3
metrau ciwb	BdjJ	3
metrau sgwâr	BdkA	8
metrig	LmI	g
metrigeiddio	B61D	r
meudwyo	B61u	3
mewian	B62l	f
mewn	gvh	Y
mewn perthynas â	BOP8	6
mewnblannu	BjkS	l
mewnbwn	19w	u
mewnbynnau	186	2
mewnbynnu	B63E	h
mewnddodi	B63l	t
mewnforiad	FHx	t
mewnforiadau	SG4	u
mewnforio	B64S	l
mewnfudo	B643	j
mewnfudwr	1/Q	s
mewnfudwyr	1+e	y
mewngofnod	FIe	t
mewngofnodi	Bips	m
mewngofnodion	SHm	u
mewnlein	Ln0	k
mewnlofnodi	BiqS	m
mewnlyncu	B65a	m
mewnol	gv5	g
mewnoli	B66A	q
mewnoliad	WA/	4
mewnoliadau	Zze	2
mewnosod	B66q	l
mewnosodiad	FJL	2
mewnosodiadau	SIU	8
mewnrwyd	2Av	v
mewnrwydau	1/8	z
mewnsaethu	B67P	o
meysydd	1Xe	m
mi	BB6w	u
micromedr	Baa0	0
micromedrau	Bfe/	7
migno	B673	j
mil	FKB	h
milenia	BTpH	s
mileniwm	BLYm	s
milfed	BCmj	j
milfeddygol	gwZ	l
milieiliad	FMT	0
milieiliadau	SMS	1
miligram	Babo	x
miligramau	Bff6	0
mililitr	BacZ	1
mililitrau	Bfgu	8
milimetr	BadO	0
milimetrau	Bfhq	4
miliwn	FKi	n
miliynau	SKF	3
miliynfed	BaeC	p
milltir	2CM	m
milltiroedd	2Be	u
miloedd	SJQ	1
milwr	2Dh	m
milwrio	B68a	k
milwrol	gw+	i
milwyr	2Cy	v
mingamu	B68+	w
minimeiddio	B69u	s
minws	BBcN	t
mireinio	B6+a	j
mis	FLJ	e
misio	B6+9	e
misoedd	SK8	p
misol	gxg	p
mitsio	B6/b	f
mo	BCnG	4
mocasin	FLn	s
mocasins	SLl	t
moch	2Eq	h
mochyn	2EH	j
modd	BWp5	n
modd	FOb	g
moddion	BWqg	s
moddion	M97	k
moddlinell	FNH	x
moddlinellau	SNH	z
model	2Fx	g
model	D3I	j
modelau	2FL	m
modelau	Qv1	q
modelu	B6/6	o
modem	D3r	j
modemau	Qwf	o
modern	gyJ	h
moderneiddio	B7Ai	s
modfedd	2G6	k
modfeddi	2GR	p
modiwl	2IK	m
modiwl	BLX6	s
modiwlareiddio	B7BO	r
modiwlau	2He	s
modiylau	BToY	v
modrwy	FN4	j
modrwyau	SN6	z
modrwyo	B7B5	e
modur	2JZ	k
moduro	B7CX	f
moduron	2Iw	p
modylu	B7C2	s
moeli	B7Di	w
moelio	B7ES	m
moes	BO6z	z
moesau	BO7m	0
moesegol	gyq	i
moesgyfarch	B7E4	r
moesol	gzM	f
moesoli	B7Fj	j
moesymgrymu	B7GG	k
moethus	BLZS	k
mogi	B7Gq	f
mohono fe	BC2b	w
mohono fi	BCsC	n
mohono fo	BCz5	x
mohono hi	BCuy	s
mohono i	BCsp	k
mohonoch chi	BC3L	w
mohonom ni	BCve	o
mohonon ni	BCwG	r
mohonot ti	BCtN	x
mohonyn nhw	BCwx	v
mohonynt	BLai	l
moldio	B7HJ	k
moli	B7Ht	g
moliannu	B7IN	s
moment	Vh4	w
momenta	BTpz	q
momentau	ZSb	5
momentwm	BLZ2	s
moni hi	BCxg	z
monitor	Vio	y
monitorau	ZTU	4
monitro	B7I5	h
monitro	BhCw	k
mono fe	BC1i	5
mono fi	BCq7	l
mono fo	BC0q	4
mono i	BCrg	i
mono ti	BCt+	0
monoch chi	BC37	5
monon ni	BCyT	0
monopoli	BLb1	s
monopolïau	BTqd	z
monyn nhw	BCzH	y
mopio	B7Ja	c
mor	BCAQ	j
mor	LpC	U
mor fywiog ag erioed	BOwG	BK
mordwyo	B7J2	c
mordwywr	FO7	r
mordwywyr	SOt	0
morgais	2Kr	o
morgannwg	BLbH	u
morgeisi	2J9	u
morgeisio	B7KS	m
morio	B7K4	e
morlas	LpW	i
morlywio	Biq4	j
moroedd	Qx2	m
morol	gzr	k
morteisio	B7LW	i
morthwylio	B7L4	l
mowldio	B7Md	l
mowntio	B7NC	e
mud	Lp4	Y
mudferwi	B7Ng	l
mudiad	BAr2	x
mudiadau	BAq+	4
mudlosgi	B7OF	o
mudo	B7Ot	g
munud	BBes	t
munudau	BBfZ	v
munudio	B7PN	n
munudol	LqQ	r
mur	2L8	i
mur gwarchod	BGH	3
muriau	2LT	p
muriau gwarchod	Noc	2
murlun	D6F	k
murluniau	QzV	q
murmuro	B7P0	j
mursennu	B7QX	r
mwg	g0P	i
mwgwd	WB3	y
mwgydu	B7RC	d
mwmial	B7Rf	j
mwmialu	B7SC	k
mwmian	B7Sm	i
mwrdro	B7TI	h
mwrnio	B7Tp	d
mwstro	B7UG	g
mwy	Lq7	Y
mwy amrywiol or hanner na 	BPnn	BM
mwy na thebyg	MLB	0
mwyach	g0x	g
mwyaf	LrT	d
mwyafrif	2NN	n
mwyafrifau	2Me	v
mwyafswm	BLch	t
mwyafsymiau	BTrQ	v
mwyara	B7Um	i
mwydioni	B7VI	g
mwydo	B7Vo	d
mwydro	B7WF	h
mwyglo	B7Wm	g
mwyhau	B7XG	j
mwyhau	Bimx	m
mwyn	2Oj	m
mwyn	BPGz	BA
mwynau	2N0	v
mwyndoddi	B7Xp	g
mwyneiddio	B7YJ	q
mwyngloddio	B7Yz	j
mwyngloddwr	BLdO	v
mwyngloddwyr	BTr/	s
mwynhad	2P1	m
mwynhadau	2PJ	s
mwynhau	B7ZW	f
mwys	BOt5	l
mwytho	B7Z1	k
mydr	BbTt	BN
mydrau	Bf6z	0
mydryddu	B7aZ	o
mydylu	B7bB	l
myfyrio	B7bm	m
myfyriwr	2RK	o
myfyrwyr	2Qb	v
mygdarthu	B7cM	o
mygu	B7c0	f
mygu	B7dT	h
mygydau	Z0U	7
mygydu	B7d0	f
myllio	B7eT	s
mympwyol	Lrw	n
mynd	BkD8	c
mynediad	BAtk	0
mynediadau	BAsn	9
mynegai	2Se	o
mynegeio	B7e/	f
mynegeion	2Ry	s
mynegi	B7fe	f
mynegi pryder	BMdy	1
mynegiad	amZ	BC
mynegiad rheolaidd	FPm	BQ
mynegiadau	Z2a	7
mynegiadau rheolaidd	SPh	BD
mynegiannau	BAva	+
mynegiant	BAuY	BC
mynegrifo	B7f9	j
myngial	B7gg	g
mynnu	B7hA	m
mynwent	2T8	t
mynwentydd	2TG	2
mynwesu	B7hm	k
mynych	BLd9	j
mynychu	B7iK	r
mynychu	Bjk3	j
mynydd	2Up	s
mynydda	B7i1	p
mynyddoedd	2VV	t
mysg	Hk7	g
mysgu	B7je	i
màs	BWpD	2
mân	Xm9	p
mânwerthu	B6fP	m
môr	D46	d
na	BB/T	X
na	BBza	BD
na	BCfP	W
na	mr	U
nac	BB0d	8
nac	Lsu	W
nacáu	B7kA	i
naddu	B7ki	e
nadolig	BLeg	w
nadredd	SQk	q
nadreddu	B7lA	h
nadroedd	BLOL	q
nadu	B7l8	b
nadu	B7lh	b
nag	Lzy	X
nage	LtE	a
naidlen	Ey+	s
naidlenni	Rw1	0
naill	Lte	c
naill	g1R	c
naill ai neu	LuO	0
nain	BLRh	y
nam	WDp	u
namau	Z3V	w
nant	2Wo	o
nas	XpG	7
natur	2X4	g
naturau	2XQ	o
naturiol	g1t	g
naw	Bafk	i
naw deg	BW6t	o
naw or gloch	BamO	u
nawddogi	B7mX	j
nawdegau	BP4N	9
nawfed	BW6L	i
nawr	LsX	X
naws	BPV1	x
nawseiddio	B7m6	m
nef	BLfQ	h
nefoedd	BTsr	o
nefoli	B7n8	h
negatif	XqB	u
neges	g2N	j
negesa	B7od	r
negeseua	B7pI	q
negesu chwim	HIL	BB
negesydd	FRY	v
negesydd chwim	Upy	BF
negesyddion	SRO	BI
negesyddion chwim	YT+	BK
negodi	Bjjv	j
negodiad	BLST	x
negodiadau	BTkE	2
negyddol	g2w	n
negyddu	B7py	d
neidio	B7qP	e
neidr	FQ2	i
neilltu	g3X	p
neilltuad	FSH	y
neilltuadau	SSW	v
neilltuedig	Xe1	w
neilltuo	B7qt	o
neilltuo	Bh2t	j
neilltuol	g4A	q
neilltuol hawdd	BMo1	0
neilltuoli	B7rV	x
neiniau	BTjP	1
neis	Jva	Z
neithiwr	Bah9	h
nentydd	2WC	m
nerth	2ZG	k
nerthoedd	2YY	u
nerthol	Lvr	e
nerthu	B7sG	m
nes	LwJ	V
nesaf at	Baj/	g
nesu	B7tO	l
nesáu	B7ss	i
neu	Lzd	V
neuadd	2aU	h
neuaddau	2Zq	q
newid	B7tz	n
newidiad	2bl	n
newidiadau	2a1	w
newidiedig	Lwe	l
newidiol	g4q	l
newidol	LxD	f
newidyn	FS5	r
newidynnau	STF	2
newydd	g5P	j
newydd sbon	iLM	p
newyddach	Lxi	r
newyddiadura	B7ua	u
newyddiadurwr	2dI	z
newyddiadurwyr	2cM	8
newyddion	FTk	q
newyddu	B7vI	f
newynu	B7vn	e
nfed	LyN	d
nhw	Lyq	c
ni	BB7e	v
ni	L0J	U
ni fydd raid	BOWs	z
nid	BLfx	j
nid pledio mo hyn	BPIz	9
nifer	WEX	t
niferoedd	Z4F	BA
niferus	g5y	m
ninnau	g6Y	g
nis	Xqv	z
nithio	B7wF	c
nitrogen	g64	r
niwclear	g7j	i
niwed	FUO	j
niwed straen ailadroddus	W5u	BU
niweidiau	ST7	1
niweidio	B7wh	q
niweidiol	g8F	o
niwl	2ev	u
niwlaidd	Xri	u
niwloedd	2d7	0
niwsans	2gL	l
niwsansys	2fd	u
niwtraleiddio	B7xL	s
niwtraliaeth	BLgU	s
nod	FUx	d
nod	WFE	q
nodau	SUw	r
nodau	Z5F	w
nodchwilydd	Uo6	4
nodchwilyddion	YS8	BC
noddfa	FV+	l
noddfeydd	SWO	p
noddi	B7x3	i
noddwr	BLhA	j
noddwyr	BTtT	y
nodedig	g8t	o
nodi	B7yZ	c
nodiad	2hZ	j
nodiadau	2gw	p
nodiannau	M/L	t
nodiannau indecs	BfFz	BF
nodiant	ULr	l
nodiant indecs	BZ8V	BG
nodwedd	2is	n
nodweddiadol	g9V	y
nodweddion	2h8	w
nodweddu	B7y1	r
nodyn	2j/	k
nodynnau	2jT	s
noeth	L0d	Z
noethi	B7zg	p
nofel	2lM	j
nofelau	2kj	p
nofio	B70J	c
nogio	B70l	b
nonagon	Baie	x
nonagonau	Bfii	z
norm	FWj	e
normal	g+H	j
normaleiddio	Bir9	y
normau	SW3	u
nos	FXB	e
nos fawrth	BVpc	z
nos fercher	BVqP	5
nos iau	BVrI	w
nos lun	BVou	u
nos sadwrn	BVss	4
nos sul	BVtk	0
nos wener	BVr4	0
nosau	SXl	p
nosi	B71A	n
noson	g+q	v
noswaith	2lv	q
nosweithiau	2mZ	s
noswylio	B71n	p
nwl	FYC	c
nwliau	SY2	k
nwy	2nr	m
nwydd	2o1	w
nwyddau	2oR	k
nwyeiddio	B72Q	i
nwyon	2nF	m
nychu	B72y	c
nyddu	B73O	g
nyrs	2qM	h
nyrsio	B73u	h
nyrsys	2pl	n
nyth	2rS	f
nythod	2qt	l
nythu	B74P	h
nôl	B7ng	c
o	BB51	V
o	BCpy	e
o amgylch	BajP	w
o blith	BO04	f
o dan	Bakf	g
o ddefnyddio 	BbIy	1
o ddifrif	Js1	n
o fewn	BVbY	z
o flaen	Bak/	q
o gwmpas	Balp	l
o nerth i nerth	BbJn	BS
o reidrwydd	BbK5	7
oblegid	g/Z	g
ochain	B74w	b
ochneidio	B75L	f
ochr	2sV	g
ochrau	2rx	k
ochrgamu	B75q	k
ochri	B76O	e
ochrolwg	BZXF	7
ochrolygon	BeoM	y
ocsidio	B76s	h
ocsigen	g/5	m
octagon	Bam8	m
octagonau	BfjV	y
octahedron	Bani	w
octahedronau	BfkH	4
octatetraen	Hlb	5
od	BLO1	h
odanynt	BLhj	r
oddeutu	hAf	j
oddi	hBC	f
oddi tan	BaoS	k
oddiar	L2M	e
oddiwrth	L2q	g
oddiwrtho	L3K	k
odl	2tZ	e
odlau	2s1	k
odli	B77N	g
odrif	Bb/g	BD
odrif	FZI	n
odrifau	BgSI	BJ
odrifau	SaG	r
oed	WFu	w
oedau	Z51	4
oedi	B77t	e
oediad	FZv	k
oediadau	Sax	v
oediedig	L3u	l
oediedig	MUd	k
oedolion	2ub	j
oedolyn	2t3	k
oedran	2vn	m
oedrannau	2u+	p
oedrannus	hBh	j
oelio	B78L	a
oen	2wz	g
oeni	B78l	e
oer	hCE	Z
oerach	Bao2	q
oeraf	Bapg	k
oeri	B79D	e
oernadu	B79h	f
oes	2xz	c
oesau	2xT	g
oesoedd	2yP	k
ofera	B7+A	o
offeiriad	2za	r
offeiriadu	B7+o	k
offeiriaid	2yz	n
offer	Qeh	z
offer	hCd	r
offeryn	204	t
offerynnau	20F	z
offrymu	B7/M	i
ofn	22P	h
ofnadwy	hDI	f
ofnau	21l	q
ofni	B7/u	g
ofnus	hDn	c
ogedu	B8AO	d
ogof	23T	d
ogofau	22w	j
ogystal	hED	l
oherwydd	hEo	h
ohoni	hFJ	i
ohono	hFr	j
ohonoch	BBq7	r
ohonom	hGO	g
ohonyn	hGu	i
ohonynt	hHQ	k
olaf	/Wm	r
olddodi	B8Ar	q
olddodi	BiF6	o
olddodiad	C7Y	s
olddodiaid	PtZ	3
olew	Faw	e
olewau	ScH	p
olfwlch	Fb/	p
olfylchau	Sde	t
olion	Sbg	n
olrhain	B8BV	g
olrheiniad	FbO	x
olrheiniadau	Scw	u
olwyn	24a	j
olwyn fesur	BaY+	9
olwynio	B8B1	d
olwynion	23w	q
olwynion mesur	Bfc6	BF
olynol	hH0	l
olynu	B8CS	g
olynwr	BLmE	q
olynwyr	BTvB	y
ombwdsmon	BLmu	r
ombwdsmyn	BTvz	u
ond	hIZ	b
ongl	FdR	f
ongl aflem	BaqE	2
ongl allanol	BXMb	x
ongl atblyg	Baq6	1
ongl fewnol	Barv	x
ongl lem	Basg	r
onglau	SfB	o
onglau aflym	Bfk/	6
onglau allanol	BdOG	BB
onglau atblyg	Bfl5	6
onglau llym	Bfnv	6
onglau mewnol	Bfmz	8
onglydd	Batx	6
onglyddion	Bfop	/
oni	hI0	d
onibai	L55	f
onid	hJR	Z
opsiwn	25o	k
opsiynau	249	r
optometrydd	BLPW	x
optometryddion	BThe	4
ordeinio	B8Cy	k
ordnans	BLlT	x
oren	263	k
orennau	26M	r
organig	hJq	e
oriau	mqw	v
oriau mân	Hgc	6
oriawr	Baur	s
oriel	BAxO	2
orielau	BAwY	2
oriorau	Bfpo	y
orthopedig	BLQH	k
orthoptydd	BLQr	2
orthoptyddion	BTiW	5
os	BLn+	k
os mai sydd 	BPdl	Bu
os nad yw yno	Bb0V	t
os oes dewis	BbnQ	2
os oes perygl fod 	BbL0	BI
osgoi	CFrb	g
otomatig	BLnZ	l
ots	hKI	h
owns	Fdw	h
ownsys	Sfp	u
pa	hKp	d
pa un ai oedd yn addas ai peidio	BEC/	BY
pab	W7C	BD
pabell	BLsd	i
pabellu	B8DW	f
pabwyra	B8D1	p
paced	FeR	i
pacedi	SgX	m
pacio	B8Ee	c
pad	Fez	d
paderu	B8E6	h
padlo	B8Fb	f
pads	Sg9	i
paent	28E	h
paentiau	27b	p
paentio	B8F6	f
paffio	B8GZ	a
paham	hLG	Y
palas	BLpR	f
palasau	BTwh	p
paldaruo	B8Gz	i
paled	FXf	j
paledau	SYO	o
palfalu	B8HV	d
palindromig	BavX	t
pallu	B8Hy	g
palmant	BLpw	s
palmantu	B8IS	g
palmentydd	BTxK	w
palu	B8Iy	g
pam	hLe	X
pan	hL1	X
paned	FfQ	m
paneidiau	Shf	u
panel	29N	i
paneli	28l	o
pantio	B8JS	d
panylu	B8Jv	b
papur	2+V	h
papur wal	Ff2	v
papurau	29v	m
papurau wal	SiN	q
papuro	B8KK	f
para	B8Kp	Y
parablu	B8LB	e
parafeddyg	BLqc	p
parafeddygon	BTx6	x
paragraff	3An	p
paragraffau	2/7	s
paralel	L7L	k
paralelogram	BawE	v
paralelogramau	Bfqa	BA
paramedr	Fgl	r
paramedrau	Si3	x
paranoiaidd	L7v	3
parasiwtio	B8Lf	m
paratoadol	L8m	o
paratoi	CFr7	k
parau	2+2	m
parc	3B+	i
parch	hMM	g
parchedig	3Cg	k
parchu	B8MF	i
parciau	3BQ	u
parcio	B8Mn	Z
parco	B8NA	c
pardduo	B8Nc	n
pardynu	B8OD	e
parhad	hMs	m
parhaol	L95	t
parhaol	L9O	r
parhaol	hNS	f
parhau	B8Oh	g
parhaus	hNx	h
parleisio	B8PB	i
parlysu	B8Pj	l
parod	hOS	g
parodrwydd	hOy	s
parsel	BLrF	k
parseli	BTyr	r
parth	3Dn	o
parth enw	BDuf	y
parthau	3DE	j
parthau enw	BQC2	y
parthu	B8QI	i
parti	3E3	g
partner	3GF	l
partneriaeth	3Hi	w
partneriaethau	3Gq	4
partneriaethol	BLrp	0
partneriaid	3FX	u
partïon	3EP	o
paru	B8Qq	a
pasio	B8RE	g
pasport	3JI	v
pasports	3IS	2
pastio	B8Rk	f
pastynu	B8SD	f
patrwm	3Kh	m
patrwm ailadrodd	Bawz	7
patrymau	3J3	q
patrymau ailadrodd	Bfra	BF
patrymlun	FhQ	t
patrymluniau	Sjo	3
patrymwaith	BP0L	t
patrymweithiau	BVQ2	4
pawb	hPe	d
pawennu	B8Si	a
pe	hP7	b
pe na bai enwr awdur 	BPAc	Ba
pebyll	BTzW	n
pechod	3Lu	h
pechodau	3LH	n
pechu	B8S8	c
pecyn	3M8	m
pecynnau	3MP	t
pecynnwr	FjG	s
pecynwyr	SmB	t
pedair	BWv1	h
pedlera	B8TY	n
pedoli	B8T/	m
pedr	BLs/	u
pedrannau	Skf	x
pedrant	Fh9	o
pedrochr	Baxu	u
pedrochrau	Bfsf	2
pedrongl	Bayc	0
pedronglau	BftV	w
pedwar	BWt6	r
pedwar deg	BazQ	w
pedwar ugain	BcwS	q
pedwaredd	BWvN	o
pedwerydd	BWul	o
pefrio	B8Ul	i
pegio	B8VH	b
pegynol	L+m	i
pegynu	B8Vi	i
peidio	B8WE	e
peillio	B8Wi	j
peilot	3OO	j
peilotiaid	3Ni	s
peint	Fil	h
peintiau	SlQ	x
peintio	B8XF	g
peiriannau	3Pf	s
peiriannau twll yn y wal	BfuF	Bc
peirianneg	hQW	r
peiriannu	BiuF	m
peiriannwr	Fjy	w
peiriant	3Ox	u
peiriant twll yn y wal	Ba1n	BN
peirianwaith	BLtt	w
peirianweithiau	BTz9	2
peirianwyr	Smu	v
peirianyddol	BLud	m
peli	3QL	k
pell	hRo	g
pellach	BW88	w
pellaf	BW9s	p
pellgyrhaeddol	BLvD	0
pellhau	B8Xl	i
pellter	hSI	u
pellterau	3SA	o
pellteroedd	3RV	r
pelydrau	YG2	4
pelydru	B8YH	i
pelydryn	UeD	2
pen	3UD	n
pen blaen	BnP	w
pen cefn	B4d	s
penaethiaid	3So	x
penarth	BWQe	k
penawdau	3V0	p
penbaladr	BGCB	2
penblwydd	3XL	u
penblwydd	Fki	t
penblwyddi	3Wd	u
penblwyddi	Snd	v
pencampwriaeth	BLv3	9
pencampwriaethau	BT0z	BA
pencawna	B8Yp	h
pendant	hS2	f
penderfyniad	3X5	0
penderfyniad didroin ôl	BbPi	Br
penderfyniadau	3Yt	1
penderfynu	B8ZK	l
penderfynwr	BLw0	BA
penderfynwyr	BT1z	1
pendifadu	B8Zv	k
pendroni	B8aT	l
pendrymu	B8a4	o
pendwmpio	B8bg	o
penelinio	B8cI	q
penglinio	B8cy	k
penigamp	Bbeh	n
penillion	3aQ	3
penio	B8dW	q
penlinio	B8eA	k
pennaeth	3TZ	q
pennaf	hTV	j
pennau	3Uq	n
pennau blaen	ONx	x
pennau cefn	OgL	s
pennawd	3VR	j
pennill	3Zi	u
pennod	3bw	q
pennu	B8ek	p
pennyn	BP3c	x
penodau	3bH	p
penodedig	hUa	k
penodi	B8fN	l
penodi	Birb	i
penodiad	BAy9	y
penodiadau	BAyE	5
penodol	hT4	i
pensaernïaeth	HmU	BB
pensil	FlP	l
pensiliau	SoM	u
pensiwn	3dG	n
pensiynau	3ca	s
pensyfrdanu	B8fy	k
pensynnu	B8gW	j
pentagon	Ba20	y
pentagonau	Bfvh	8
pentagram	Ba3m	z
pentagramau	Bfwd	z
pentomino	Ba+7	s
pentominos	Bf03	1
pentre	BLyq	4
pentref	3ea	o
pentrefi	3dt	t
pentwr	Fl0	j
pentwr	FmX	j
pentwr	WGe	w
pentyrrau	So6	s
pentyrrau	Spm	s
pentyrrau	Z6t	3
pentyrru	B8g5	e
penwythnos	3fz	r
penwythnosau	3fC	x
penydio	B8hX	k
penynnau	BVTh	0
perarogli	B8h7	r
perchen	Biur	n
perchennog	3h/	p
perchenogaeth	BLzi	y
perchenogaethau	BT3X	BA
perchenogi	B8im	n
perchnogaeth	3jW	z
perchnogaethau	BL0U	x
perchnogi	B8jN	m
perchnogion	3io	u
perchnogol	L/o	r
pereiddio	B8jz	l
pererindota	B8kY	3
pererinio	B8lP	3
perffaith	hVh	s
perffeithio	B8mG	q
perfformiad	3lC	4
perfformiadau	3kJ	5
perfformiadol	BL2J	3
perfformio	B8mw	p
perfformiwr	BL3A	7
perfformwyr	BT4X	9
peri	B8nZ	l
perifferol	IyV	u
perifferolion	YE5	BI
perifferolyn	UcV	BB
perimedr	Ba4Z	v
perimedrau	BfxQ	y
perpendicwlar	Ba5I	BE
persawr	3ge	y
persawrau	3hQ	v
persawrio	B8n+	r
persawru	B8op	o
person	3mu	p
personau	3l6	0
personol	hW1	l
personoleiddio	BivS	v
personoleiddydd	Fm6	BD
personoleiddyddion	SqS	8
personoli	B8pR	p
personél	hWN	o
perswadio	B8p6	i
pert	L/I	g
perthnasau	3oE	s
perthnasedd	BL5c	y
perthnasoedd	BT5U	BB
perthnasol	hXa	o
perthyn	B8qc	k
perthynas	3nX	t
perthynas	BL6O	Bb
perthynol	hYC	n
perwyl	3pc	t
perwylau	3ow	s
perygl	3q0	l
peryglon	3qJ	r
peryglu	B8rA	l
peryglus	hYp	r
pesgi	B8rl	l
pesimistaidd	BPY8	n
peswch	B8sK	k
pesychu	B8su	g
petai	MBe	x
peth	3sC	j
pethau	3rZ	p
petrol	hZU	p
petrus	I6W	i
petruso	B8tO	l
petryal	Fn9	q
petryal	MC1	k
petryalau	SrO	w
peuo	B8tz	b
piau	MDZ	l
pibell	Bjl	k
pibellau	OJz	m
pibellu	Bh5T	k
pibo	B8uO	l
pibyddio	B8uz	m
picedu	B8vZ	j
picellu	B8v8	e
picio	B8wa	b
piclo	B8w1	h
picsel	Fon	k
picseleiddio	Bh37	q
picseli	Sr+	7
picsfap	FpL	m
picsfapiau	Ss5	w
pictogram	Ba6M	x
pictogramau	BfyC	BI
piffio	B8xW	i
pigo	B8x4	e
pilcota	B8yW	m
pilio	B8y8	b
pilo	B8zX	b
pinbwyntio	B8zy	l
pinc	MD+	c
pincio	B80X	f
ping	WIw	y
pingau	Z9T	6
pingio	BiwB	r
pinio	B802	b
pinsio	B81R	d
pipio	B81u	h
piso	B82P	b
pistyllio	B82q	h
pistyllu	B83L	g
pitw	MEa	Y
pitïo	B83r	c
pladuro	B84H	q
plaen	XsQ	k
plaenio	B84x	j
plagio	B85U	i
plaid	BAzv	5
planau	Z+N	0
planed	3tO	j
planedau	3sl	p
planedig	JyK	n
planhigion	3tx	s
planhigyn	3ud	m
plannu	B852	f
plant	3vu	r
planta	B86V	s
plastig	hZ9	r
plastro	B87B	j
platfform	Fpx	r
platfformydd	Stp	w
platinwm	HnV	s
pledio	B87k	h
pleidiau	BA0o	3
pleidio	B88F	g
pleidlais	3xE	j
pleidleisiau	3wZ	r
pleidleisio	B88l	g
plentyn	3vD	r
pleser	hao	n
pleserau	3xn	z
pleserus	BL7p	r
plesio	B89F	f
plethu	B89k	f
pletio	B8+D	g
plicio	B8+j	m
plisgau	Z/B	BA
plisgo	B8/J	f
plisgyn	WKP	8
plismona	B8/o	i
plith	hbP	k
plot	FrE	e
plotiau	SvG	q
plotio	B9AK	d
plotydd	Fri	o
plotyddion	Svw	w
pluennu	B9An	h
plufio	B9BI	f
pluo	B9Bn	n
pluog	BL8U	k
plwg	FsK	g
plwm	/XR	x
plws	Ba69	r
plwyf	3zF	n
plwyfi	3ya	r
plwyfo	B9CO	r
plwyfoli	B9C5	p
plycio	B9Di	g
plygell	Fqc	o
plygellau	SuZ	t
plygiau	Swg	m
plygio	Bh7T	l
plygio byw	JA4	s
plygu	B9EC	c
plymio	B9E7	h
plymio	B9Ee	d
plân	WJi	t
pnawn	30V	l
pnawnau	3zs	p
po	hbz	i
pob	hcV	Z
pobi	B9Fc	b
pobl	hcu	f
pobl gyffredin	BdCB	7
poblogaeth	31r	r
poblogaethau	306	x
poblogaidd	MEy	h
poblogeiddio	B9F3	p
poblogi	B9Gg	i
pobol	hdN	g
pocedu	B9HC	f
podiatrydd	BL84	w
podiatryddion	BT6V	6
poen	33H	q
poenau	32W	x
poeni	B9Hh	c
poenydio	B9H9	u
poergarthu	B9Ir	l
poeri	B9JQ	e
poeth	hdt	Y
poethach	Ba7o	k
poethaf	Ba8M	s
poethi	B9Ju	d
polareiddio	B9KL	q
polau piniwn	BT7P	BB
polioni	B9K1	l
polisi	34c	j
polisïau	33x	r
polisïol	BL+a	m
polygon	++	q
polygon	FYe	q
polygonau	NgB	t
polygonau	SZa	s
polygoneiddio	BitY	t
polyhedron	Ba84	x
polyhedronau	BfzK	4
polylinell	Fsq	0
polylinellau	SxG	z
polynomaidd	Ba9p	m
polyomino	Ba+P	s
polyominos	Bf0C	1
ponsio	B9La	f
pont	35t	l
pontio	B9L5	g
pontydd	34/	u
pop	/YC	l
popeth	heF	p
popeth dan haul	BbYi	4
poptai	BWEy	j
popty	BVuY	m
porfelu	B9MZ	q
pori	B9ND	e
portffolio	37C	p
portffolios	36S	w
porth	3+Y	m
porth	4AR	x
porth	U9t	z
porthau	39D	u
porthi	B9Nh	d
porthiannau	37r	u
porthiant	38Z	q
porthladd	3/q	n
porthladdoedd	3++	s
porthmona	B9N+	q
porthoedd	4BC	t
porthor	DrM	r
porthorion	Qhp	8
portreadu	B9Oo	l
porwr	4CU	p
porwyr	4Bv	l
porydd	4Dr	p
poryddion	4C9	u
pos	Fte	f
posau	Sx5	n
posib	heu	f
posibiliad	4FK	u
posibiliadau	4EU	2
posibilrwydd	/Yn	4
posibl	hfN	h
positif	hfu	i
post	/Zf	l
poster	4Gs	t
posteri	4F4	0
postgyfuno	BjDp	w
postio	B9PN	b
pot	Ft9	b
potelu	B9Po	f
potensial	hgQ	s
pothellu	B9QH	l
potiau	Syg	u
potio	B9Qs	n
potsio	B9RT	e
powdro	B9Rx	g
powlio	B9SR	g
practis	4IG	o
practisys	4HZ	t
prancio	B9Sx	f
prawf	aq5	n
preblan	B9TQ	g
pregethu	B9Tw	i
pregethwr	4KD	s
pregethwyr	4JX	s
preifat	hg8	j
preifateiddio	B9US	q
preifatrwydd	hhf	v
premiwm	4Lg	t
premiymau	4Kv	x
pren	BA2Q	x
pren mesur	BaXJ	2
prenio	B9U8	k
prennau	BA1f	x
prennau mesur	Bfa2	BA
prentisiaeth	BL/A	8
prentisio	B9Vg	m
prepian	B9WG	m
pres	hiO	j
pres poced	Ba/n	3
presennol	hix	q
presenoldeb	hjb	q
presenoli	B9Ws	v
preswyl	4M9	p
preswyliau	4MN	w
preswylio	B9Xb	i
preswylwr	4Oa	v
preswylwyr	4Nm	0
pridd	4Pz	m
priddau	4PJ	q
priddio	B9X9	n
priddo	B9Yk	e
prif	hkF	k
prifathrawon	BT8Q	1
prifathro	BL/8	z
prifddinas	UiI	y
prifddinasoedd	YLO	0
prifffrydio	BjmX	s
priffordd	4RF	o
priffyrdd	4QZ	s
prifio	B9ZC	o
priflythrennau	ORu	2
priflythrennol	Xjn	0
priflythrennu	BhAq	z
priflythrennu	Bif3	x
priflythyren	Bqh	9
prifol	BbAe	3
prifswm	WL+	2
prifsymiau	aA3	6
prifysgol	4Sh	v
prifysgolion	4Rt	0
prin	hkp	m
prinder	4Vl	p
prinderau	4Uz	y
prinhau	B9Zq	m
print	hlP	h
printio	B9aQ	h
priod	hlw	d
priodas	4UG	t
priodasau	4TQ	2
priodasol	hmN	l
priodddull	Bbc4	r
priodddulliau	Bf+I	t
priodi	B9ax	f
priodol	hmy	f
priodoledd	FuY	x
priodoleddau	SzO	v
priodoli	B9bQ	l
priodwedd	4XA	s
priodwedd	WM0	9
priodweddau	4WO	y
priodweddau	aBx	BG
pris	4YZ	m
prisiad	BMCO	u
prisiadau	BT9F	0
prisiau	4Xs	t
prisio	B9b1	f
prism	BbBV	s
prismau	Bf1s	v
problem	4Zs	m
problemau	4Y/	t
procio	B9cU	e
proffesiwn	BMC8	3
proffesiynau	BT95	6
proffesiynol	BMG3	Bb
proffesiynol	hnR	x
proffesiynoldeb	BMDz	4
proffesiynolion	BT/2	+
proffesu	B9cy	j
proffidio	B9dV	l
proffidiol	BMIS	y
proffil	/Kd	u
proffiliau	/LL	u
proffwydo	B9d6	l
profi	B9e+	g
profi	B9ef	f
profi	Bj3Q	j
profiad	4bD	r
profiadau	4aS	x
profiadol	hoC	p
profion	4Iu	p
proflen	UhP	5
proflenni	YKQ	+
proflennu	BhCJ	n
profocio	B9fe	k
project	4ce	o
projectau	4bu	w
proses	4d2	p
prosesau	4dG	w
prosesu	B9gC	k
prosesydd	FvJ	w
prosesyddion	Sz9	v
prosiect	4fO	p
prosiectau	4ef	v
prosthetydd	BMJ/	0
prosthetyddion	BUBx	8
protestio	B9gm	j
protocol	4go	s
protocolau	4f3	x
pruddglwyfus	BOdZ	n
pruddhau	B9hJ	h
prun	MFT	e
prun	hp8	l
pryd	4iA	k
prydain	BMKz	1
prydau	4hU	s
prydeinig	BMLo	p
pryder	4jM	j
pryderon	4ik	o
pryderu	B9hq	i
pryderus	BMdF	t
prydferth	hor	u
prydferthu	B9iM	o
prydles	4kZ	l
prydlesi	4jv	q
prydlon	BMMR	h
prydu	B9i0	j
prydyddiaeth	BPvE	q
prydyddu	B9jX	m
pryf cop	CI8	r
pryfed cop	Ozd	t
pryfedu	B9j9	n
pryfocio	B9kk	l
prygowtha	B9lJ	f
prynhawn	4lv	r
prynhawnau	4k+	x
pryniant	BMMy	v
prynol	I/Q	j
prynu	B9lo	e
prynwr	4nF	m
prynwyr	4ma	r
prysur	hpZ	j
prysuro	B9mG	i
pum	BWyQ	x
pum deg	BbCB	s
pumed	BWxq	m
pummlynedd	BMAv	w
pump	iR0	q
punnau	BQ70	v
punnoedd	BA3B	x
punt	BA3y	o
punt	BGMC	1
pur	hqh	a
pureiddio	B9mo	l
puro	B9nN	k
puteinio	B9nx	f
pwdr	BMNh	e
pwdu	B9oQ	f
pwerau	4nr	m
pwerus	hq7	o
pwffian	B9ov	j
pwffio	B9pS	d
pwll	4pY	g
pwlpio	B9pv	h
pwmpio	B9qQ	c
pwnc	BA5Q	r
pwnio	B9qs	d
pwno	B9rJ	a
pwrcasu	B9rj	i
pwrpas	4qh	j
pwrpasau	4p4	p
pwrpasol	hrj	h
pwrpasu	B9sF	g
pwrs	BMOr	f
pwtio	B9sl	c
pwy	hsE	a
pwyllgor	4rE	v
pwyllgorau	4rz	s
pwyllo	B9tB	f
pwynt	4tJ	p
pwyntiau	4sf	q
pwyntiaur cwmpawd	BYMA	BA
pwyntio	B9tg	j
pwyntydd	Fv5	q
pwyntyddion	S0s	3
pwyo	B9uD	f
pwys	4ua	h
pwys	BbDd	s
pwysau	4ty	o
pwysedd	Buw	p
pwyseddau	OWX	4
pwysi	Bf2b	4
pwysicach	I/z	s
pwysicaf	hse	u
pwysig	htM	e
pwysigrwydd	htq	w
pwyslais	4vn	m
pwysleisiau	4u7	s
pwysleisio	B9ui	l
pwyso	B9vH	d
pwysyn	BbEJ	8
pwysynnau	Bf3T	BM
pwytho	B9vk	g
pybyr	BMPK	i
pydru	B9wE	Z
pygu	B9wd	i
pyledig	MFx	m
pyllau	4o0	k
pyllu	B9w/	b
pylpio	BjUQ	i
pylu	B9xa	b
pymtheg	BW+V	n
pymthegfed	BW+8	w
pynciau	BA4a	2
pyncio	B9x1	e
pynio	B9yT	c
pynnu	BjnD	i
pyramid	BbFF	s
pyramidau	Bf4f	z
pyrsau	BUDr	y
pyrth	39x	n
pyrth	YpF	6
pysgod	4w5	l
pysgodfa	4yQ	p
pysgodfeydd	4xe	y
pysgodyn	4wN	s
pysgota	B9yv	d
pystylad	B9zM	e
pystyladu	B9zq	q
pythefnos	4zw	w
pythefnosau	4y5	3
pythefnosol	BMBf	v
pytio	BhcR	m
pâr	2/c	f
pêl	3Qv	m
pêldroed	hRB	n
pêr	hU+	j
pôl piniwn	BL9o	y
pŵer	4oR	j
pŵl	Xdm	o
pŵl	XeO	n
radian	Fwj	m
radianau	S1j	y
radio	41P	n
radiograffeg	BMPs	t
radiograffwr	BMQZ	w
radiograffwyr	BUEd	BF
radiograffydd	BMRJ	+
radiograffyddion	BUFi	BC
radios	40g	v
radiws	FxJ	n
radiysau	S2V	s
rali	42d	j
ralis	412	n
rangyflenwad	BMTA	BM
rangyflenwadau	BUHe	BD
rasio	B90U	b
realistig	hua	m
realiti	hvA	u
record	43n	i
recordiau	43A	n
recordio	B90v	j
recriwtio	Bjnl	k
refeniw	hvu	u
refferendwm	449	u
refferendwms	44J	0
reidio	B91S	f
reit	hwc	g
relaiau	aEy	+
relái	WPe	0
rhacanu	B91x	n
rhad	hw8	e
rhadroddi	B92Y	o
rhaeadrol	BMVk	m
rhaeadrol	MGX	k
rhaeadru	B93A	l
rhaffo	B93l	e
rhaffu	B94D	d
rhag	hyE	a
rhagair	BMUz	x
rhagamod	Fxw	v
rhagamodau	S3B	x
rhagarfaethu	B96B	q
rhagarwain	B96r	n
rhagarweiniol	hxa	q
rhagarwyddo	B97S	7
rhagbenodi	B98N	6
rhagchwilio	B99H	z
rhagddarbodi	B996	1
rhagddewis	Bix6	0
rhagddi	BMUM	n
rhagddiffiniedig	MG7	x
rhagddiffinio	Biyu	p
rhagddo	hye	t
rhagddodi	B9+v	q
rhagddodiad	C6o	w
rhagddodiaid	Psj	2
rhagddweud	B9/Z	t
rhagddyddio	B+AG	r
rhagddyfalu	B+Ax	y
rhagddywedyd	B+Bj	r
rhagdyb	BPtb	p
rhagdybiaeth	Fyf	3
rhagdybiaethau	S3y	z
rhagdybiau	BVP0	BC
rhagdybied	B+CO	p
rhagdybiedig	BMZc	q
rhagdybio	B+C3	p
rhageiriau	BUIh	4
rhagfarn	46h	y
rhagfarnau	45r	2
rhagfarnu	Bjox	s
rhagffurfweddiad	FzW	BG
rhagffurfweddiadau	S4l	BE
rhagflaenu	B+Dg	s
rhagfyfyrio	B+EM	0
rhagfynegi	B+FA	q
rhagfynegi	Bj49	k
rhagfynegiad	Bb12	t
rhagfynegiadau	BgI3	BB
rhagfyr	BDVd	l
rhagglorineiddio	B94g	2
rhaggynllunio	B95W	r
rhaghysbysu	B+Fq	t
rhaglen	48D	q
rhaglengell	WQS	/
rhaglengelloedd	aFw	BG
rhaglenigion	S6k	+
rhaglenni	47T	w
rhaglennig	F1O	v
rhaglennu	B+GX	r
rhaglennwr	F0c	y
rhaglenwyr	S5p	7
rhaglunio	B+HC	2
rhaglwythedig	MAT	m
rhaglwytho	Bh94	l
rhaglwytho	Biws	o
rhagnodi	B+H4	u
rhagod	B+Im	o
rhagofalu	B+JO	w
rhagolwg	F19	s
rhagolygon	S7i	w
rhagolygu	B+J+	q
rhagor	hzL	j
rhagorchmynion	RCl	+
rhagorchymyn	EJN	4
rhagori	B+Ko	k
rhagoriaeth	BVWT	6
rhagorol	hzu	l
rhagosod	B+LM	n
rhagosodedig	MIU	8
rhagosodiad	WRR	1
rhagosodiadau	aG2	7
rhagosodol	MHs	o
rhagrithio	B+Lz	y
rhagrybudd	BMSH	5
rhagrybuddio	B+Ml	v
rhagrybuddion	BUGk	6
rhagweithiol	h0T	r
rhagweithredol	BMaG	v
rhagweld	B+NU	k
rhagymadrodd	BMa1	/
rhagymadroddion	BULO	BI
rhai	MJQ	k
rhaid	4/X	t
rhain	h0+	g
rhamantu	B+N4	q
rhampio	B+Oi	k
rhan	F2p	d
rhanadwy	Bb1C	0
rhanamser	h1e	u
rhanbarth	49e	r
rhanbarthau	48t	x
rhanbarthol	h2M	k
rhanddeiliad	BMb0	BR
rhanddeiliaid	BUMW	BL
rhanedig	MJ0	u
rhaniad	BA6z	w
rhaniadau	BA57	4
rhannau	S8S	x
rhannol	h2w	l
rhannu	B+PG	q
rhannu	Bj5h	f
rhannun union i	Bb3H	BE
rhasglu	B+Pw	j
rhatach	h3V	l
rhataf	Bb2j	k
rhathu	B+QT	g
rhawio	B+Qz	c
rhechu	B+RP	c
rhedadwy	KkA	q
rhedeg	B+Rr	d
rhedeg	BhX4	o
rhedeg	BhXF	z
rhedegol	MKi	f
rhediad	4+z	k
rhediad	WH9	z
rhediad	WHO	v
rhediad argraffu	BIBM	2
rhediadau	4+J	q
rhediadau	Z7k	1
rhediadau	Z8Z	6
rhediadau argraffu	BSB/	BC
rhediadol	Kkq	u
rhedlefel	F3G	v
rhedlefelau	S9D	2
rhegi	B+SI	f
rheibio	B+Sn	h
rheiddiadu	B+TI	l
rheiddio	B+Tt	k
rheidiau	5AE	t
rheidrwydd	h36	s
rheilffordd	5Bb	u
rheilffyrdd	5Ax	q
rheini	h4m	c
rheiny	h5C	j
rheithgor	5C4	r
rheithgorau	5CJ	v
rheng	5EQ	n
rhengau	5Dj	t
rhent	5Fd	g
rhentau	5E3	m
rhenti	5F9	l
rhentio	B+UR	f
rhentu	B+Uw	f
rheol	5H4	s
rheolaeth	5HM	s
rheolaethau	5Gi	q
rheolaidd	MMe	v
rheolau	5Ik	q
rheoledig	h5l	m
rheoleiddio	B+VP	u
rheoleiddiwr	BMll	BN
rheoleiddwyr	BUNh	y
rheoli	B+V9	i
rheoliad	5J8	t
rheoliadau	5JO	u
rheoliadol	h6L	o
rheolwaith	WSG	9
rheolweithiau	aHx	BJ
rheolwr	5Lc	p
rheolwyr	5Kp	z
rheolydd	F31	u
rheolydd	F4j	r
rheolyddion	S+o	1
rheolyddion	S95	v
rhes	anb	x
rhesi	aI6	8
rhestr	5Mu	l
rhestrau	5MF	p
rhestredig	h6z	s
rhestriad	F5O	r
rhestriadau	S/d	1
rhestru	B+Wf	f
rhesu	BixU	m
rheswm	5N9	k
rhesymau	5NT	q
rhesymeg	h7f	w
rhesymegol	h8P	r
rhesymegu	B+W+	r
rhesymol	h86	p
rhesymu	B+Xp	q
rhethregu	B+YT	v
rhew	h9j	q
rhewbwynt	Bb4L	0
rhewbwyntiau	BgJ4	BA
rheweiddio	B+ZC	p
rhewi	B+Zr	n
rhewi	Bha4	s
rhiant	5PK	m
rhianta	Bjpd	f
rhibinio	B+aS	j
rhic	Bb4/	t
rhiciau	BgK4	s
rhicio	B+a1	k
rhidyll	WTD	4
rhidyllau	aJ2	+
rhidyllio	B+bZ	m
rhidyllu	B+b/	e
rhieni	5Oh	p
rhif	5QW	h
rhif arnawf	BP16	0
rhif coll	Bb5s	u
rhif cymysg	Bb6a	BB
rhif cysefin	Bb7b	0
rhif prifol	Bb9U	BJ
rhif trefnol	Bb8P	BF
rhifau	5Pw	m
rhifau arnawf	BVRu	1
rhifau coll	BgLk	BC
rhifau cymysg	BgMm	BD
rhifau cysefin	BgNp	7
rhifau prifol	BgPw	BP
rhifau trefnol	BgOk	BM
rhifedd	h+N	r
rhifiadol	MN4	p
rhifiadur	F55	x
rhifiaduron	TAS	3
rhifo	B+cd	h
rhifol	MOh	o
rhifolion	5Rg	o
rhifolyn	5Q3	p
rhifydd	WT7	3
rhifyddion	aK0	2
rhifyddol	MPJ	u
rhifyn	BA7j	/
rhifyn	BMmy	BC
rhifynnau	BUOT	BI
rhigoli	B+c+	g
rhigymu	B+de	j
rhincian	B+eB	j
rhincio	B+ek	f
rhinwedd	5S2	s
rhinweddau	5SI	u
rhisglio	B+fD	i
rhith	L02	b
rhithfro	D5X	u
rhithfröydd	Qyc	5
rhithio	B+fl	1
rhithiol	BMqj	8
rhochian	B+ga	h
rhochio	B+g7	g
rhodd	5UO	l
rhoddi	B+hb	g
rhoddion	5Ti	s
rhoden	BcAj	6
rhodenni	BgTR	BA
rhodio	B+h7	i
rhodli	B+id	g
rhodresgar	Bc+e	p
rhodresu	B+i9	g
rhofio	B+jd	d
rhoi	CFnJ	e
rholian	B+j6	f
rholiau	5Uz	o
rholio	B+kZ	d
rholio	BhFd	BK
rhombi	BgUR	1
rhombws	BcBd	x
rhonc	BMss	m
rhoncio	B+k2	j
rhostio	B+lZ	g
rhostir	5Wr	n
rhostiroedd	5V8	v
rhuchio	B+l5	e
rhuddo	B+mX	f
rhufeinig	MSd	e
rhugl	h+4	b
rhuglo	B+m2	f
rhuo	B+nV	c
rhusio	B+nx	f
rhuthro	B+oQ	g
rhwbio	B+ow	d
rhwchio	B+pN	f
rhwdu	B+ps	e
rhwng	h/T	h
rhwyd	5X+	i
rhwydau	5XS	s
rhwydd	h/0	c
rhwyddhau	B+qK	p
rhwyddhaur ffordd iddo	BbM8	BH
rhwydo	B+qz	h
rhwydwaith	5ZP	o
rhwydweithiau	5Yg	v
rhwydweithio	BizX	r
rhwyfo	B+rU	k
rhwygadwy	MQk	n
rhwygo	B+r4	d
rhwym	BMtS	4
rhwym o golli	BMuK	r
rhwymedigaeth	5az	0
rhwymedigaethau	5Z3	8
rhwymiad	F7b	p
rhwymiadau	TCA	1
rhwymo	B+sV	g
rhwymynnu	B+s1	i
rhwystr	5ci	2
rhwystrau	5bn	7
rhwystredig	BMv0	BB
rhwystredigaeth	BMu1	/
rhwystredigaethau	BURy	BP
rhwystro	B+tX	h
rhy	BCBY	V
rhybedio	B+t4	h
rhybedu	B+uZ	f
rhybudd	5eG	n
rhybuddio	B+u4	k
rhybuddion	5dY	u
rhychwant	BMw1	BO
rhychwantau	BUTB	BF
rhychwantu	B+vc	j
rhyddfreinio	B+v/	t
rhyddfrydig	BOcm	z
rhyddhad	5ff	p
rhyddhadau	5et	y
rhyddhau	B+ws	l
rhyddid	iAQ	l
rhydu	B+xR	i
rhydyllu	B+xz	n
rhyfedd	iA1	g
rhyfeddod	5gI	w
rhyfeddodau	5g4	s
rhyfeddol	iBV	m
rhyfeddu	B+ya	p
rhyfel	5iR	t
rhyfela	B+zD	k
rhyfeloedd	5hk	t
rhyferthwy	BMyD	y
rhyferthwyau	BUUG	BH
rhyfygu	B+zn	r
rhygnu	B+0S	h
rhygyngu	B+0z	l
rhyngbroffesiynol	BMy1	4
rhyngbrosesol	MP3	t
rhyngddo	iB7	n
rhyngddynt	iCi	u
rhyngol	XGk	BG
rhyngosod	Bi0C	n
rhyngrwyd	iDQ	s
rhyngu	B+1Y	h
rhyngweithiad	F8i	5
rhyngweithiadau	TDm	7
rhyngweithio	Bi0p	s
rhyngweithiol	iD8	v
rhyngweithredu	Bi2P	1
rhyngwladol	iEr	u
rhyngwladoli	Bi1V	6
rhyngwyneb	F6q	x
rhyngwynebau	TBJ	3
rhyngwynebu	B+15	q
rhynnu	B+2j	g
rhythu	B+3D	h
rhyw	F8E	e
rhyw	MRL	n
rhyw	MRy	r
rhywbeth	iFZ	z
rhywfaint	MT7	i
rhywfaint	iGM	z
rhywfath o	BMzt	0
rhywiau	TC1	x
rhywiol	iG/	i
rhywle	iIK	p
rhywogaeth	5i+	w
rhywogaethau	BBrm	y
rhywsut	H3q	i
rhywun	iHh	p
rhôl	5Vb	h
risg	5kT	p
risgiau	5ju	l
rolau	5k8	l
rowlio	B+3k	d
rownd	BM0h	BF
rowndiau	BUVN	BG
rwbel	BM2X	k
rwdlan	B+4B	v
rwdlian	B+4w	m
rwseg	W9Y	v
rwsia	HoB	j
rwsiaidd	MTT	o
rwyf yn amheus yn ei gylch	BbaG	BD
rygbi	iIz	j
rôl	5lh	f
rŵan	MS7	Y
sach	5mj	e
sachau	5mA	j
sacio	B+5W	c
sadio	B+5y	i
sadrwydd	HDJ	r
sadwrn	BVoJ	l
saer	5nq	k
saernïo	B+6U	h
saesneg	BM1m	x
saeth	5o0	h
saethau	5oO	m
saethiad	F9b	n
saethiadau	TEh	p
saethu	B+61	e
safbwynt	5qG	q
safbwyntiau	5pV	x
saffach	MA5	l
safiad	BM27	z
safiadau	BUWT	BF
safio	B+7T	a
safle	5rg	n
safle tirlenwi	BNl/	8
safleoedd	5qw	w
safleoedd tirlenwi	BUuA	6
safnio	B+7t	g
safnrhythu	B+8N	l
safon	5s1	k
safonau	5sH	u
safoni	B+8y	l
safonol	iJW	i
safwe	5uE	m
safweoedd	5tZ	r
saib	F+C	f
saib	WUy	s
sail	5vU	i
sain	5we	f
saint	5w9	m
saith	BW4A	f
saith deg	BW/s	i
saithdegau	BP5K	0
salwch	5yK	k
salychau	5xj	n
samona	B+9X	m
sampl	5zX	j
samplau	5yu	p
samplo	B+99	e
samplu	B++b	j
sancsiwn	BM3u	p
sancsiynau	BUXY	w
sanctaidd	iKS	h
sancteiddio	B+++	m
sanfaganeiddio	BjuA	5
sangu	B+/k	e
sant	59B	r
sarhad	BM4X	m
sarhadau	BUYI	y
sarhau	B/AC	e
sarnu	B/Ag	c
sarsio	B/A8	l
sathru	B/Bh	e
sawl	iKz	Z
sawl math	BDsk	3
sawrio	B/B/	d
sawru	B/Cc	b
sbarduno	B/Dx	f
sbario	B/EQ	d
sbecian	B/FH	b
sbectol	/aE	/
sbectrwm	50m	m
sbectrymau	5z6	s
sbeis	BVyA	n
sbeisys	BWHe	m
sbeitio	B/Fi	j
sbidomedr	BcC0	s
sbidomedrau	BgVz	z
sbio	B/GF	a
sbiral	BcCO	m
sbiralau	BgVG	t
sblasio	B/Gf	f
sboncio	B/G+	g
sbondonics	BM49	BL
sbotliw	F/W	s
sbotliwiau	TG4	x
sbridiri	BM6I	BI
sbrintio	B/He	j
sbwliau	TIg	r
sbwlio	Bi3E	j
sbwlydd	GAC	o
sbwlyddion	THp	3
sbwriel	iL1	k
sbwylio	B/IB	d
sbïo	B/Et	a
sbŵl	GAq	h
sebon	512	k
sebonau	51M	q
seboni	B/Ie	g
seco	B/I+	c
secondio	B/Ja	j
secretu	B/J9	i
sector	53E	m
sectorau	52a	q
sedd	/E6	g
seddau	53q	n
sef	iMZ	k
sefydledig	iM9	p
sefydliad	55B	u
sefydliadau	54R	w
sefydliadol	iNm	o
sefydlog	+5Q	c
sefydlog	XDD	/
sefydlogi	B/Kf	m
sefydlogrwydd	iOO	5
sefydlu	B/LF	h
sefydlu cynsail	BM7Q	2
sefyll	B/Lm	h
sefyllfa	56p	t
sefyllfaoedd	55v	6
segment	BcDg	o
segmentau	BgWm	t
segur	Ms9	i
segur	iPH	n
segura	B/MH	f
seguro	B/Mm	m
seibiau	TFK	2
seibiau	TOv	7
seibio	B/NM	g
seiciatreg	BM8G	3
seiciatrig	iPu	0
seiciatrydd	BM89	+
seiciatryddion	BUY6	3
seiclo	B/Ns	f
seicolawdriniaeth	BM+v	9
seicoleg	BM/s	s
seicolegol	iQi	r
seicolegwr	BNAY	BC
seicolegwyr	BUap	1
seiffr	GBL	k
seiffrau	TJL	t
seiliau	5uq	q
seiliedig	iRN	n
seilio	B/OL	g
seilwaith	58T	u
seilweithiau	57W	9
seimio	B/Or	j
seinegol	MVB	m
seiniau	5v2	o
seinio	B/PO	h
seiniol	BPys	x
seintiau	59s	r
seinydd	WWL	t
seinyddion	aMb	5
seinyddol	MVn	u
seiri	5nB	p
seisnigeiddio	B/Pv	q
seisnigo	B/QZ	l
seithfed	BW4f	l
selau	BA9R	z
selio	B/Q+	d
seminar	5+9	q
seminarau	5+X	m
senedd	6AZ	r
seneddau	5/n	y
seneddol	iSe	v
sengi	B/Rb	g
sengl	iTN	b
sennu	B/R7	r
sensitif	iTo	o
sensitifrwydd	iUQ	v
septagon	BcEI	q
septagonau	BgXT	s
serch	iU/	q
serchu	B/Sm	j
seremoni	6C5	m
seremonïau	6CM	t
seren	6BE	m
serennu	B/TJ	g
serfio	B/Tp	d
serio	B/UG	b
sero	GBv	f
seroau	TJ4	m
serth	iVp	o
sesiwn	6ES	s
sesiynau	6Df	z
set	6Fk	g
setiau	6E+	m
setliad	6Gx	m
setliadau	6GE	t
setlo	B/Uh	d
sfferau	TKe	p
sffêr	GCO	j
sgaldian	B/U+	i
sgaldio	B/Vg	f
sganio	B/V/	c
sganiwr	GCx	o
sganwyr	TLH	q
sgathru	B/Wb	c
sgeintio	B/W3	k
sgema	GDZ	j
sgemâu	TLx	n
sgerbwd	GD8	q
sgerbydau	TMY	s
sgileffaith	BNCH	3
sgileffaith	UMQ	v
sgileffeithiau	BUbe	4
sgileffeithiau	TNE	3
sgiliau	6HX	s
sgio	B/Xb	b
sgipio	B/X2	d
sgiwedd	Hok	q
sglefrholio	B/YT	t
sglefrio	B/ZA	k
sglein uchel	MXj	v
sgleinio	B/Zk	g
sgleiniog	MWV	o
sglodion	BNC+	x
sgorau	6Im	o
sgori	B/aE	e
sgorio	B/ai	l
sgrafellu	B/bH	l
sgrap	BNEi	n
sgrapio	B/bs	k
sgrechain	B/cQ	i
sgrechian	B/cy	j
sgrechio	B/dV	l
sgrialu	B/d6	j
sgriblan	B/ed	o
sgriblian	B/fF	o
sgriblo	B/ft	m
sgrifennu	B/gT	i
sgrin	6KY	j
sgriniau	6Jv	p
sgrinio	B/g1	i
sgrinlun	GEm	u
sgrinluniau	TN7	0
sgript	6Lo	l
sgriptiau	6K7	t
sgriptio	Bi4P	r
sgriwio	B/hX	i
sgrolio	Bi3n	o
sgrolydd	GFU	s
sgrolyddion	TPq	2
sgrwbio	B/h5	h
sgwad	BNFz	h
sgwadiau	BUdN	u
sgwariau	6MN	s
sgwario	B/ia	l
sgwaryn	BcEy	q
sgwarynnau	BgX/	w
sgwennu	B/i/	i
sgwlcan	B/jh	h
sgwrio	B/kC	h
sgwrs	6OG	j
sgwrsio	B/kj	f
sgwâr	6M5	l
sgyrsiau	6Ne	o
sgìl	6ID	j
sgôp	HpO	i
sgôr	6JO	h
si	6j0	h
siafio	B/lC	g
siafo	B/li	f
sialens	6PY	n
sialensau	6Op	v
sialensio	B/mB	m
siambr	6Qr	m
siambrau	6P/	s
sianel	/EV	l
sianeli	6RR	p
sianelu	B/mn	i
siapan	Hpw	i
siapanaidd	MY7	y
siapaneg	W8F	BT
siapiau	6R6	k
siapio	B/nJ	g
siapo	B/np	e
siarad	B/oH	g
siaradwr	6Ts	n
siaradwyr	6TC	q
siario	B/on	f
siarsio	B/pG	f
siart	6U/	n
siart cylch	BYcf	6
siartiau	6UT	s
siartiau cylch	Bd+p	BC
siartredig	BNFJ	q
siawns	6WQ	i
siawns dda	BcGP	w
siawns deg	BcH3	3
siawns wael	BcFc	z
siawnsiau	6Vm	q
siawnsiau da	BgZs	2
siawnsiau gwael	BgYv	9
siawnsiau teg	Bgbe	/
siawnsio	B/pl	f
siawnsys	6Wy	r
sibrwd	B/qE	e
sibrwd	BNGU	r
sibrydion	BUd7	1
sicr	BcIu	m
sicr	iWR	Y
sicrhau	B/qi	f
sicrwydd	6YK	s
sicrwyddau	6Xd	t
sidan	6Zg	k
sidanau	6Y2	q
sidellu	B/rB	h
sidyllio	B/ri	k
siec	6as	i
siec teithio	BcJU	/
sieciau	6aE	o
sieciau teithio	Bgcd	BJ
siffrwd	B/sG	g
sifftio	Bjp8	j
sifil	iWp	b
sigaren	BNG/	q
sigarennau	BUew	7
siglo	B/sm	e
sigo	B/tE	f
silff	BNHp	j
silffoedd	BUfr	v
silindr	GGd	q
silindrau	TRE	y
silio	B/tj	g
sillaf	GHH	m
sillafau	TR2	o
sillafiad	GHt	v
sillafiadau	TSe	x
sillafu	B/uD	g
sillwyddor	Gx3	x
sillwyddorau	T/i	5
silwair	6b5	j
silweiriau	6bO	r
simsan	B/uj	f
simsanu	B/vC	g
sin	6dF	i
sinau	6cc	p
sinema	6eP	i
sinemâu	6dn	o
sioc	6fe	i
siociau	6ex	t
siocled	6gs	m
siocledi	6gA	s
sioe	6h6	i
sioeau	6hS	o
siom	6jL	p
siomau	6ic	v
siomedig	iXE	k
siomi	B/vi	i
sionc	MZt	i
sioncio	B/wE	l
siop	6lX	g
siop stopcyntaf	BNIM	4
siopa	B/wp	b
siopau	6k3	g
siopau stopcyntaf	BUga	+
siopwr	BcK9	u
siopwyr	Bgeh	m
sipian	B/xE	d
sipio	B/xh	a
sir	6mf	f
sirioli	B/x7	i
siroedd	6l3	o
sirol	iXo	e
sisial	B/yd	d
siswrn	GJi	w
sisyrnau	TUM	z
siwglo	B/y6	e
siwgr	6nn	g
siwgrau	6m+	p
siwr	MaP	e
siwrhau	B/zY	f
siwrnai	6oz	m
siwrneiau	6oH	s
siwtio	B/z3	f
siâp	6Se	k
siŵr	Mat	a
slaes	WW4	o
slaesau	aNU	t
slafaidd	BNJE	f
slawer dydd	BNJj	7
sleifio	B/0W	f
slobran	B/01	i
slotian	B/1X	h
slotio	B/14	d
smala	BPVU	h
smalio	B/2V	f
smocio	B/20	e
smonach	BNKe	0
smotiau	aLq	x
smotyn	WVe	t
smwddio	B/3S	e
smyglo	B/3w	g
smygu	B/4Q	c
snap	GKS	d
snapiau	TU/	6
snapio	Bi6Y	f
sniffian	B/4s	g
snwffian	B/5M	i
snwffio	B/5u	i
sobreiddio	B/6Q	l
sobri	B/61	h
sobrio	B/7W	i
soced	GLV	j
socedi	TWi	m
soddi	B/74	d
sodli	B/8V	w
sodro	B/9F	d
soffistigedig	iY7	t
solet	MbH	a
solid	BcLr	g
solidau	BgfH	y
sombi	GL4	j
sombïaid	TXI	s
somi	B/9i	h
sonio	B/+D	f
sonion	6pZ	r
sorri	B/+i	b
sortio	B/+9	c
sosialaeth	BNLS	2
sosialaidd	BMWK	q
sosialwr	BMW0	u
sosialwyr	BUJZ	5
sosialydd	BMXi	v
sosialyddion	BUKS	8
stad	6rO	g
stadau	6qo	m
staenio	B//Z	d
staeno	B//2	d
stafell	6sZ	j
stafelloedd	6ru	r
staff	iZo	v
staffio	Bjqf	f
stamp	6tq	n
stampiau	6s8	u
stampiedig	BNMI	j
stampio	CAAT	e
stampo	CAAx	e
statig	BNMr	k
statudol	iaX	y
statws	6u7	i
statysau	6uR	q
steil	6wG	i
steiliau	6vd	p
stensil	GMb	o
stensiliau	TX0	t
steryllu	CABP	m
sticio	CAB1	f
stigmateiddio	CACU	q
stilio	CAC+	e
stiwardio	CADc	p
stiwdio	6xT	l
stiwdios	6wo	r
stoc	6yg	j
stocanu	CAEF	f
stocddaliad	BNNP	3
stocddaliadau	BUhY	4
stociau	6x4	o
stocio	CAEk	q
stocrestr	BNOG	r
stocrestrau	BUiQ	2
stompio	CAFO	f
stonau	aOB	1
stondin	BA+z	u
stondinau	BA+E	v
stop	GND	e
stopiau	TYh	p
stopio	CAFt	g
stordai	TZK	w
stordy	GNh	o
storfa	BBAY	u
storfeydd	BA/h	3
stori	62F	n
storio	CAGN	f
storm	60Q	m
stormydd	6zs	k
storïau	6zD	p
straen	61i	j
straeniau	602	s
straeon	62s	n
strancio	CAGs	q
strapio	CAHW	g
strategaeth	64C	u
strategaethau	63T	v
strategol	ibJ	k
streic	BBCA	x
streiciau	BBBG	6
streicio	CAH2	n
stribed	BV9j	x
stribedi	BWOt	3
strimio	CAId	f
strwythur	65q	z
strwythurau	64w	6
strwythuredig	ibt	u
strwythuro	CAI8	n
strwythurol	icb	t
stryd	67O	n
strydoedd	66d	x
stumogi	CAJj	h
stwffio	CAKE	i
stwmpo	CAKm	e
stwnsh	WYP	v
stwnsiau	aO2	2
stwnsio	BhaM	s
stwnsio	CALE	l
stôn	WXg	v
sudd	68f	i
suddion	671	q
suddo	CALp	g
sugno	CAMJ	d
sugnydd llwch	BMF2	BB
sugnyddion llwch	BT+z	BD
sul	mL	g
suliau	TZ6	n
suo	CAMm	a
suro	CANA	c
sut	idI	m
swalpio	CANc	i
swatio	CAN+	f
swbachu	CAOd	g
swcro	CAO9	j
swigen	GOJ	n
swigod	Tah	n
swits	69s	j
switsfwrdd	GOw	y
switsfyrddau	TbI	z
switsio	CAPg	g
switsys	69B	r
swm	6+z	d
swmpo	CAQA	d
swnan	CAQd	i
swnial	CAQ/	e
swnian	CARd	h
swnio	CAR+	c
swno	CASa	a
swnydd	GPi	k
swnyddion	Tb7	q
swp	GQG	d
swper	7A7	i
swpera	CAS0	i
swperau	7AT	o
swperu	CATW	i
swydd	BBDm	v
swyddfa	7CJ	l
swyddfa bost	BaOk	8
swyddfar post	BcML	8
swyddfeydd	7Bd	s
swyddi	BBCx	1
swyddog	7De	n
swyddogaeth	7E7	u
swyddogaeth	HqS	6
swyddogaethau	7EF	2
swyddogaethol	BNOx	w
swyddogion	7Cu	w
swyddogol	ieV	g
swydfeydd post	BfTY	/
swydfeydd y post	Bgf5	BD
swyno	CAT4	e
sy	Bjq+	k
sybachu	CAUW	f
sych	ie1	W
sychdarthu	CAU1	m
sychedu	CAVb	h
sychlyd	BPlB	z
sychu	CAV8	a
sydd	Mbh	d
sydyn	ifL	k
syflu	CAWW	g
syflyd	CAW2	h
syfrdanol	ifv	i
syfrdanu	CAXX	k
sylfaen	7Gi	z
sylfaenol	igR	m
sylfaenu	CAX7	d
sylfeini	7Fp	5
syllio	CAYY	d
syllu	CAY1	d
sylw	7IA	m
sylw dyledus	BIq7	BA
sylwad	7JP	k
sylwadau	7Im	p
sylwau	7HV	r
sylwebu	CAZS	m
sylwedd	7Kk	o
sylweddadwy	BNPh	s
sylweddau	7Jz	x
sylweddol	ig3	q
sylweddoli	CAZ4	o
sylwi	BjIT	m
sylwi	CAag	e
sym	BcNH	l
symbol	7L5	m
symbolaidd	Mb+	k
symbolau	7LM	t
symbyliad	BNQN	3
symbyliadau	BUjG	v
symbylio	CAa+	i
symbylu	CAbg	l
symiau	6+P	k
symiau	Bgg8	q
symio	CAcF	m
syml	ihh	i
symlach	BMYR	j
symleiddio	CAcr	k
symlrwydd	GQj	v
symlrwyddau	TdS	0
symlu	CAdP	f
symposia	BUj1	6
symposiwm	BNRE	2
symptom	7NM	n
symptomau	7Mf	t
symud	CAdu	e
symudadwy	Mci	i
symudiad	7Oj	q
symudiadau	7Nz	w
symudol	iiD	l
symudwr	GRS	r
symudwyr	TeG	p
syn	iio	Z
syn amrywio o ran eu perthnasedd	BL37	Bh
synagog	BVxY	o
synagogau	BWGq	0
syndod	7QC	s
syndodau	7PN	1
synergedd	BNR6	s
synfyfyrio	CAeM	i
synhwyrau	7RX	o
synhwyro	CAeu	m
synhwyrol	ijB	o
synhwyrydd	GR9	u
syniad	7Sm	n
syniadau	7R/	n
syniau	6/Q	l
synied	CAfU	d
synio	CAfx	c
synnu	CAgN	o
synnwyr	7Qu	p
syntheseiddio	MdE	v
syntheseiddyddion	Tfh	7
syntheseisydd	GSr	9
synthesis	BNSm	w
synthesisau	BUkv	5
synthetig	BMY0	o
synwyryddion	Tev	y
sypiau	Tcl	t
sypio	CAg1	h
sypynio	CAhW	g
sypynnu	CAh2	f
syrffed	BdFy	0
syrffedu	CAiV	u
syrffio	BjoJ	o
syrilig	Jjk	m
syrthio	CAjD	d
system	7T6	k
systematig	ijp	j
systemau	7TN	t
syth	ikM	j
sythu	CAjg	k
sythu	CAkE	g
sâl	iJ4	a
sêl	BA8i	v
sêl	BcG/	4
sêls	Bgai	8
sêr	6Bq	i
sïo	B/C3	a
sïon	6kV	i
sôn	6qE	k
sôn	B/DR	g
sŵ	idu	n
sŵn	6/1	e
ta	Lt6	U
tab	GTo	d
tabernaclu	CAkk	l
tabiau	Tgc	t
tabl	BBFF	r
tabl chwech	BcNs	z
tabl colyn	CII	0
tablau	BBEV	w
tablau chwech	Bghm	3
tablau colyn	Oyf	+
tabler	GaG	o
tableri	ToX	6
tablydd	GUF	p
tablyddion	ThJ	+
tabyrddio	CAlJ	h
tabyrddu	CAlq	e
tachwedd	BDUx	s
tacio	CAmI	b
taclo	CAmj	k
taclu	CAnH	h
tacluso	CAno	g
tacsi	7VF	i
tacsis	7Ue	n
tacteg	BNXF	i
tactegau	BUnU	r
tactegol	Ji9	n
tad	7WL	g
tadau	7Vn	k
tadogi	CAoI	g
tadolaeth	ikv	0
taenellu	CAoo	h
taenlen	GUu	t
taenlenni	TiH	w
taenu	CApJ	c
taer	BNZH	d
taeru	CApl	h
tafarn	7XV	k
tafarnau	7Wr	q
tafellu	CAqG	h
taflen	7Yj	n
taflenni	7X5	q
taflodi	CAqn	o
taflu	CArP	d
taflunio	CArs	i
tafodi	CAsO	g
tafol	BcOf	t
tafolau	Bgid	z
tafoli	CAsu	i
tag	GVb	e
tagiau	Ti3	n
tagio	Bi63	e
tagu	CAtQ	a
tai	7ZK	k
taid	BNV9	n
tair	BWtU	m
taith	7aW	h
tal	ilj	Z
talach	BcPM	o
talaf	BcP0	b
talchu	CAtq	h
talchu	CAuL	h
taldra	BcRK	m
taldra	HrM	l
talentog	BNWk	h
talfyredig	Mdz	x
talfyriad	BcRw	r
talfyriadau	BgkY	x
talfyrru	CAus	l
talgrychu	CAvR	i
talgryniad	GV5	v
talgryniadau	Tje	z
talgrynnu	CAvz	q
taliad	7bj	k
taliadau	7a3	s
talidau sefydlog	BgjQ	BI
tally marks	BfW5	y
talmu	CAwd	d
taloedd	jr9	p
talu	CAw6	c
tameidio	CAxW	u
tameidiog	BNbP	k
tan	imk	W
tanamcangyfrifo	CAyE	z
tanasio	CAy3	h
tanau	7cH	n
tanbeidio	CAzY	e
tanberfformio	CAz2	v
tancer	BV6V	q
tanchwa	BZy1	o
tanchwaoedd	BfAm	7
tanfor	Jk/	h
tanfuddsoddi	CA0l	5
tangiad	GWo	m
tangiadau	TkR	t
tangloddio	CA1e	p
tangnefeddu	CA2H	o
tangram	BcSb	k
tangramau	BglJ	z
tangynrychioli	CA2v	5
taniad	GXO	j
taniadau	Tk+	0
tanio	CA3o	m
tanlinelliad	GXx	3
tanlinelliadau	Tly	3
tanlinellu	CA4O	r
tannu	CA45	n
tano	Mek	s
tanseilio	CA5g	w
tansoddi	CA6Q	h
tansuddo	CA6x	q
tanwydd	7dz	i
tanwyddion	7dN	m
tanysgrifiad	GYo	7
tanysgrifiadau	Tmp	4
tanysgrifiedig	MfQ	0
tanysgrifio	CA7b	l
tapiau	7eV	o
tapiau mesur	Bfd/	BA
tapio	CA8A	g
tapo	CA8g	n
taranu	CA9H	k
tardd	BcS/	x
tarddellu	CA9r	t
tarddiad	7gH	l
tarddiadau	7fe	p
tarddion	Bgl8	p
tarddu	CA+Y	g
tarfu	CA+4	c
targed	7ha	l
targed	GgQ	l
targedau	7gs	u
targedau	NCL	x
targedu	CA/U	f
tarian	GZj	j
tarianau	Tnh	2
taro	CA/z	g
tasg	7in	h
tasgau	7h/	o
tasglu	BNbz	9
tasgluoedd	BUn/	3
tasgu	CBAT	d
tasio	CBAw	b
tasu	CBBL	f
taten	7ju	h
tatws	7jI	m
taw	Bcfb	q
taw	im6	Y
tawel	inS	Y
tawelu	CBBq	d
tawelwch	inq	i
tawlu	CBCH	c
te	ioM	d
tebyg	iop	h
tebygol	BcTw	g
tebygol	ipK	c
tebygolwrydd	Gau	8
tebygolwryddau	TpR	1
tebygrwydd	ipm	u
tebygu	CBCj	f
techneg	7k5	n
technegau	7kP	q
technegol	iqU	o
technoleg	7mW	v
technolegau	7lg	2
technolegol	iq8	x
teclyn	Gbq	l
teclynnau	TqG	q
tecáu	CBDC	i
teg	irt	g
tegeirian	GcP	t
tegeirian	Tqw	6
teidiau	BUmd	3
teigr	Gc8	j
teigrod	Trq	q
teilo	CBDk	f
teils	TsU	o
teilsen	Gdf	m
teilsio	Bi7V	n
teilwra	CBED	f
teilwrio	CBEi	j
teilynghau	CBFF	k
teilyngu	CBFp	i
teimlad	7n6	s
teimladau	7nF	1
teimlo	CBGL	f
teip	BNcw	x
teipiadur	DEm	z
teipiaduron	P4L	4
teipiau	BUo2	5
teipio	CBGq	h
teipograffeg	Hrx	9
teirannu	CBHL	o
teithiau	7Zu	o
teithio	CBHz	k
teithiol	isN	v
teithiwr	7pY	r
teithwyr	7om	y
teitl	7qs	m
teitlau	7qD	p
telathrebiad	Edl	/
telathrebiadau	RZK	BH
telathrebu	BiZJ	w
telecsio	CBIX	h
teledu	CBI4	i
teleffon	GeF	t
teleffonau	M/4	s
teleffoni	Hsu	x
telegynadledda	CBJa	y
teleiechyd	BNdh	p
teler	BBGi	r
telerau	BBFw	y
telewerthu	BNeK	q
telori	CBKM	h
telynegu	CBKt	s
tempro	CBLZ	h
tempru	CBL6	v
temtasiwn	BdHc	v
temtasiynau	Bgzk	u
temtio	CBMp	f
tenant	7r+	k
tenantiaeth	BNfw	z
tenantiaethau	BUpv	x
tenantiaid	7rS	s
tenau	MgE	Z
tendio	CBNI	l
tendr	BNgj	BB
tendrau	BUqg	2
tendro	Bjri	e
teneuach	BcUQ	k
teneuaf	BcU0	h
teneuo	CBNt	d
tensiwn	BNhk	3
tensiynau	BUrW	8
terfyn	BBIC	v
terfynau	BBHN	1
terfynell	Gey	u
terfynellau	NAk	w
terfyniad	Gfg	w
terfyniadau	NBU	3
terfynol	is8	e
terfynu	CBOK	j
terfysgu	CBOt	k
term	7tK	g
termau	7si	o
testun	7uQ	g
testunau	7tq	m
testunol	BNib	g
tetrahedron	BcVV	s
tetrahedronau	Bgml	BD
tetromino	BcWB	u
tetrominos	Bgno	3
teulu	7uw	p
teuluoedd	7vZ	q
teuluol	ita	l
tew	BcWv	b
tewach	BcXK	h
tewaf	BcXr	n
tewhau	CBPR	f
tewi	CBPw	k
tewychu	CBQU	i
teyrnasu	CBQ2	k
teyrngarwch	BNi7	s
thatcheriad rhonc	BMrf	BN
thatcheriaid rhonc	BUQj	BP
theatr	7ws	u
theatrau	7wD	p
thema	7yC	j
themâu	7xa	o
theori	7zS	j
theorïau	7yl	t
therapi	70o	o
therapiwtig	BNTW	u
therapydd	BNUE	w
therapyddion	BUlo	1
therapïau	7z1	z
thermodynamig	Mgd	8
thermomedr	BcrU	0
thermomedrau	BguR	BB
thesawrus	Htf	v
thesawrws	BbbJ	6
thesawrysau	Bf9M	8
ti	/bD	d
ti	BCqQ	b
ticer	Ghf	j
ticeri	Ts8	p
ticio	CBRa	c
til	BcYS	y
tiliau	Bgof	w
timau	71Q	q
tincial	CBR2	e
tincio	CBSU	g
tindroi	CFsf	i
tipian	CBS0	j
tipyn	73H	l
tipynnau	72c	r
tir	74U	f
tirfeddiannwr	BNjn	0
tirfeddiannwyr	BUsS	z
tirio	CBTX	b
tiriogaeth	BNkb	x
tiriogaethau	BUtF	7
tirioni	CBTy	i
tirlenwi	BNlM	z
tirlun	75i	l
tirluniau	74z	v
tirlunio	CBUU	k
tiroedd	73s	o
tirwedd	BBJk	t
tirweddau	BBIx	z
tirweddu	CBU4	j
tisian	CBVb	f
tisio	CBV6	g
tiwbio	CBWa	i
tiwnio	CBW8	h
tiwtor	762	k
tiwtoriaid	76H	v
tlawd	it/	f
tlodi	CBXd	i
tlotaf	BNU0	p
tlws	BNVd	g
to	78C	f
tocio	CBX/	c
tocyn	79J	g
tocynnau	78h	o
toddi	CBYb	c
toeau	77a	o
toglo	CBY3	e
toi	CFte	b
tolach	CBZV	f
tolachu	CBZ0	f
tolchennu	CBaT	g
tolcio	CBaz	d
tolio	CBbQ	g
tolli	CBbw	o
tomen	GiC	m
tomen graidd	WY+	2
tomennu	CBcY	h
tomennydd	Ttl	r
tomennydd craidd	aPs	9
ton	7+Q	f
tonau	7+v	j
toncio	CBc5	e
tonfedd	Gio	r
tonfeddi	TuQ	t
tonnau	79p	n
tonni	CBdX	d
top	8AR	c
topi	CBd0	e
topiau	7/v	i
topio	CBeS	i
torchi	CBe0	d
torcytundeb	BP5+	BA
torcytundebau	BVUV	BF
toredig	KDp	k
toreithiau	BUw0	5
toreth	BNrd	v
toreth o wybodaeth	BNsM	BK
torf	BV0x	t
torfeydd	BWJg	8
torfol	BNtW	t
torfynyglu	CBfR	m
torheulo	CBf3	h
toriad	8BS	e
toriad	BDoU	z
toriadau	8At	l
toriadau	BP9U	BC
torri	CBgY	c
torsythu	CBg0	h
torth	BV0B	w
torthau	BWIx	v
torthi	CBhV	q
tostio	CBh/	i
tosturio	CBih	e
tosturiol	BOM8	w
tra	BPzd	u
tra	iue	g
traarglwyddiaethu	CBi/	w
traawdurdodi	CBjv	o
trac	8Cb	h
trachwantu	CBkX	i
trachywiredd	HuO	3
traciau	8Bw	r
tracio	CBk5	j
traddodi	CBlc	BB
traddodi	CBmd	8
traddodiad	8Dr	o
traddodiadau	8C8	v
traddodiadol	iu+	o
tradwy	BcZE	l
tradyrchafu	CBnZ	l
traean	8FF	s
traeanau	8ET	y
traeanu	CBn+	r
traed	8GX	j
traenio	CBop	i
traeth	8Hh	j
traethau	8G6	n
traethawd	BBKR	3
traethodau	BBLI	2
traethu	CBpL	m
trafaelio	CBpx	r
trafaelu	CBqc	j
trafferth	8I0	q
trafferthion	8IE	w
trafferthu	CBq/	m
traffig	ivm	l
traflyncu	CBrl	k
trafnidiaeth	iwL	3
trafod	BNwC	8
trafod	CBsJ	k
trafod data	BcZp	n
trafodaeth	8KT	x
trafodaethau	8Je	1
trafodion	BUy6	1
trafriwio	CBst	1
tragwyddol	ixC	n
tragwyddoli	CBti	r
trais	8YO	r
trallodi	CBuN	l
trallwyso	CBuy	n
tramgwydd	8L6	v
tramgwyddau	8LE	2
tramgwyddo	CBvZ	n
tramor	ixp	o
trampio	CBwA	o
trampo	CBwo	h
tramwyfa	8Ng	w
tramwyfeydd	8Mp	3
tramwyo	CBxJ	l
trannoeth	BXAO	r
trannoeth	BcaQ	m
transffer	BIkC	m
transfferau	BSTE	1
trapesiwm	Bca2	o
trapesiymau	BgpP	t
traphont	BNw+	z
traphontydd	BUzv	x
trapio	CBxu	i
traswfudiadau	Bgp8	BF
traul	+9d	o
traw	W+H	t
trawiad	GjT	m
trawiadau	Tu9	t
trawiadol	Mj1	m
trawiadol	iyR	p
traws	iy6	d
trawsacennu	CByQ	n
trawsblannu	CBy3	n
trawsddodi	CBze	n
trawsdoriad	BXA5	z
trawsdoriadau	BXBs	6
trawsfeddiannu	CB0F	l
trawsffiniol	BNxx	t
trawsffurfiad	D1G	6
trawsffurfiadau	QtO	7
trawsffurfio	CB0q	w
trawsfudiad	Bcbe	5
trawsfudo	Bj6A	u
trawsfudo	CB1a	t
trawsgludo	CB2H	s
trawsgyfeirio	CB2z	2
trawsgyweirio	CB3p	3
trawsleoli	CB4g	s
trawslifio	CB5M	u
trawslythrennu	CB56	7
trawsnewid	BccX	2
trawsnewid	CB61	x
trawsnewidiad	Gj5	7
trawsnewidiadau	BgrB	8
trawsnewidiadau	Tvq	3
trawsnewidiol	Mkb	v
trawssybsideiddio	BjsA	1
trawswyro	CB7m	r
trawsyrru	CB8R	q
tre	BNn5	1
treblan	CB87	s
treblu	CB9n	k
trechu	CB+L	m
tref	8O5	i
trefi	8OQ	p
trefn	BBL+	2
trefnau	8Pb	s
trefniad	8Q0	t
trefniad	BNm7	+
trefniadaeth	BNye	u
trefniadaeth	W+0	8
trefniadaethau	BU0g	3
trefniadau	8QH	t
trefniadau	BUu6	BC
trefniadol	BNzM	u
trefniannau	8SV	x
trefniant	8Rh	0
trefnlen	Gk0	r
trefnlenedig	MlK	u
trefnlenni	Twh	y
trefnlennu	Bi78	2
trefnlennydd	Glf	1
trefnlennyddion	TxT	BC
trefnol	BcdN	k
trefnu	BjGg	z
trefnu	CB+x	k
trefnwr	8Tz	u
trefnwyr	8TG	t
trefnydd	8VR	r
trefnyddion	8Uh	w
trefol	izX	k
treftadaeth	8Wx	u
treftadaethau	8V8	1
treial	8Xf	v
treialon	arg	p
treialu	CB/V	f
treiddio	CB/0	k
treiglad	BO2d	8
treiglad llaes	BO3Z	BE
treiglad meddal	BO4d	BE
treiglad trwynol	BO5h	BS
treigladau	BVIB	3
treigladau llaes	BVI4	BT
treigladau meddal	BVKL	BL
treigladau meddal	BVLW	BF
treiglio	CCAY	g
treiglo	CCA4	g
treillio	CCBY	i
treinio	CCB6	i
treio	CCCc	f
treisiau	8Y5	m
treisio	CCC7	h
tremio	CCDc	k
tremu	CCEA	i
tremygu	CCEi	h
trenau	8Zf	j
trengi	CCFD	h
trennydd	Bcdx	t
tresbasu	CCFk	j
tresio	CCGH	d
tresmasu	CCGk	m
treth	8bM	f
treth ar werth	Bcee	9
treth incwm	BZ7l	w
trethadwy	iz7	h
trethdalwr	BNou	s
trethdalwyr	BUv8	4
trethi	8ao	k
trethi incwm	BfE2	9
trethu	CCHK	c
treuliau	+81	o
treulio	CCHm	k
treulio	CCIK	h
tri	BWsw	k
tri deg	Bcgx	n
tribiwnlys	8cc	q
tribiwnlysoedd	8br	x
tridimensiwn	BY+K	x
trigain	BNpa	c
trigeinfed	BchY	3
trigfannu	CCIr	m
trigiannu	CCJR	i
trigo	CCJz	f
trigo	CCKS	d
trigolion	8d/	y
trigolyn	8dG	5
trigonometregol	MhZ	w
trimio	CCKv	h
trin	CCLQ	g
tringar	XXZ	z
triniaeth	8fj	w
triniaethau	8ex	y
trinio	CCLw	f
trinydd	BBvz	s
trinyddion	BBx+	1
trio	BjH1	e
triongl	GmU	o
trionglau	TyV	w
trionglog	BciP	p
triphlyg	KEN	j
tripio	CCMP	e
trist	i0c	c
tristáu	CCMt	h
triwantiaeth	BNp2	w
tro	8g+	l
troad	Bci4	x
troad	VTG	1
troad llawn	Bcjp	z
troadau	Bgr9	m
troadau	ZCn	7
troadau llawn	Bgsj	4
trochi	CCNO	e
trochi	CCNs	f
troed	8Fx	m
troedfedd	BBNv	x
troedfeddi	BBM0	7
troedio	CCOL	f
troedior llwyfan	BL1F	BE
troednodiad	CeE	z
troednodiadau	PL4	7
troedyn	WZ0	t
troedynnau	aQp	0
troelli	CCOq	f
troelliad	Gg1	q
troelliadau	NC8	1
troellog	BcmI	i
troellwr	BNz6	y
troellwr dillad	BN0s	5
troellwyr	BU1X	4
troellwyr dillad	BU2P	4
troeon	8gT	r
troethi	CCPJ	e
troi	CFD0	e
trolio	CCPn	d
tromino	Bcmq	v
trominos	Bgtb	2
tros	BcnZ	l
tros	i04	j
trosedd	8jr	l
troseddau	8jA	r
troseddol	i1b	i
troseddu	CCQE	n
troseddwr	8lB	s
troseddwyr	8kQ	x
trosfwaol	BH8Y	u
trosglwyddiad	/Mr	z
trosglwyddiadau	/L5	y
trosglwyddo	CCQr	o
trosi	Bhc3	p
trosi	CCR2	f
trosi	CCRT	j
trosiad	WLL	z
trosiadau	aAB	2
trosiadu	CCSV	t
trosiannau	8lt	y
trosiant	8mf	u
troslun	Wah	9
trosluniau	aRd	BF
trosodd	BHeW	h
trosol	BN1l	p
trosolion	BU3H	u
trosolwg	BN2O	2
trosolygon	BU31	4
trosroddi	CCTC	s
trostynt	MiJ	w
trosydd	Gm8	r
trosyddion	TzF	6
trosysgrifo	CCTu	n
trothwy	8n9	r
trothwyau	8nN	w
trotian	CCUV	e
trotio	CCUz	i
truenus	BEal	f
trugarhau	CCVV	l
trugarog	BOMW	m
trullio	CCV6	v
truthio	CCWp	h
trwblio	CCXK	h
trwblo	CCXr	k
trwch	DVm	l
trwch blewyn	I9I	w
trwchus	i19	d
trwco	CCYP	j
trwm	i2a	h
trwmpo	CCYy	h
trwsiad	VT7	w
trwsiadau	ZDi	8
trwsiadus	i27	p
trwsio	CCZT	e
trwy	i3k	b
trwy gydol y drafodaeth	LDa	Bf
trwyadl	BPsu	t
trwybwn	GoP	r
trwybynnau	T0s	z
trwydded	8pX	q
trwyddedau	8oo	v
trwyddedig	i3/	r
trwyddedu	CCZx	j
trwyddynt	Mi5	8
trwyn	8qs	k
trwynau	8qB	r
trwyno	CCaU	c
trwytho	CCaw	i
trybaeddu	CCbS	l
tryboli	CCb3	l
tryc	Wbe	t
trychiau	QMM	z
trychinebus	BEZ4	t
trychu	CCcc	d
tryciau	aSi	1
trydan	i4q	n
trydanol	i5R	s
trydanu	CCc5	k
trydar	CCdd	l
trydedd	BWwW	o
trydydd	BWw+	s
tryferu	CCeC	h
tryledu	CCej	g
tryleu	Ml4	w
trylifo	CCfD	h
tryloyw	Mmo	x
tryloywder	BCox	r
tryloywder	WcL	5
tryloywderau	aTX	BC
trylwyr	i59	h
trymach	Bcn+	q
trymaf	Bcoo	l
trymhau	CCfk	j
trynewid	BhZc	w
trynewid	WdE	y
trynewidion	aUZ	6
trysori	CCgH	k
trysorlys	Go6	0
trysorlysoedd	T1f	2
trystio	CCgr	i
trywanu	CChN	j
trywydd	8r6	j
trywydd	Wd2	2
trywyddion	8rQ	q
trywyddion	aVT	9
trên	8aC	m
tröell	8iV	r
tröellau	8hj	y
tu	i6e	h
tu allan i	BcpN	n
tu mewn	BV+U	q
tu mewn i	Bcp0	g
tu ôl i	BcqU	h
tua	BB+8	X
tua	BB+e	e
tua	i6/	e
tuag	i7d	b
tuchanu	CChw	i
tudalen	8tL	m
tudalennau	8sd	u
tudalennu	Bi8y	j
tudalennydd	Gqg	1
tudalenyddion	T3L	8
tuedd	8ui	n
tueddau	8tx	x
tueddiad	8v5	q
tueddiadau	8vJ	w
tueddol	Bcq1	f
tueddu	CCiS	i
tun	8xQ	i
tuniau	8wj	t
tunnell	8yZ	h
tunnelli	8xy	n
turio	CCi0	f
turnio	CCjT	p
tuthian	CCj8	f
tuthio	CCkb	f
twf	BEZF	z
twlcio	CCk6	e
twll	8zh	i
twnelau	T4H	w
twnelu	CClY	f
twnnel	GrV	l
twr	80n	d
twrf	82u	h
twrian	CCl3	h
twrio	CCmY	g
twristaidd	BEXA	p
twristiaeth	BEXp	x
twsian	CCm4	f
twt	ICE	W
twtio	CCnX	d
twyll	831	g
twyllau	83P	m
twyllo	CCn0	f
twyllodrus	BEYa	r
twymno	CCoT	c
twymo	CCov	c
twyn	84V	l
twyni	846	k
tybaco	i74	k
tybed	i8c	g
tybiaeth	86q	p
tybiaethau	858	u
tybied	CCpL	f
tybiedig	i88	j
tybio	CCpq	f
tycio	CCqJ	f
tycio	CCqo	b
tydi	/bg	o
tyfiannau	87T	v
tyfiant	88C	p
tyfu	CCrD	b
tylino	CCre	d
tyllau	8y6	n
tyllu	CCr7	g
tymereddau	89b	v
tymheredd	88r	w
tymheru	CCsb	f
tymhorau	8+y	x
tymhorol	i9f	i
tymor	8+K	o
tymorbyr	BEVk	w
tymorcanol	BEU3	t
tymorhir	BEWU	s
tyndroi	CFtB	d
tyneru	CCs6	d
tyngedfennol	BEUL	s
tyngedfennu	CCtX	n
tynghedu	CCt+	f
tyngu	CCud	f
tynhau	CCu8	h
tynnu	Bj6u	h
tynnu	Bj7P	q
tynnu	CCvd	l
tynnu i ffwrdd	Bj75	p
tyrchio	CCwC	k
tyrchu	CCwm	e
tyrfau	82H	n
tyrfo	CCxE	f
tyrfu	CCxj	e
tyriau	81E	l
tyrrau	80D	k
tyrru	CCyB	c
tyst	9BD	w
tystio	CCyd	f
tystiolaeth	9AT	w
tystiolaethau	8/j	w
tystiolaethu	CCy8	l
tystion	9Bz	w
tystysgrif	9DR	v
tystysgrif	DLP	0
tystysgrifau	9Cj	u
tystysgrifau	P/t	8
tystysgrifedig	J6b	9
tystysgrifo	Bi9V	r
tywallt	CCzh	d
tywarch	BN3E	v
tywarchu	CCz+	e
tyweirch	BU4t	0
tyweirch artiffisial	BN3z	6
tywod	9Ey	o
tywodydd	9EA	y
tywodyn	jsm	2
tywydd	9GH	l
tywyddau	9Fa	t
tywyll	i+B	i
tywyllach	J5G	k
tywyllhau	CC0c	i
tywyllu	CC0+	r
tywyllwch	9Hd	q
tywyllychau	9Gs	x
tywynnu	CC1p	f
tywysio	CC2I	f
tywysog	9I5	p
tywysogion	9IH	y
tywysu	CC2n	h
tâl	il8	o
tâl sefydlog	BcQP	7
tân	7cu	f
tâp	7e9	h
tâp mesur	BaZ7	5
tîm	716	i
tôn	7/S	d
tŵr	81p	e
tŷ	85e	e
ubain	CC3I	e
uchaf	i+j	i
uchafbwynt	9Ka	s
uchafbwynt	BcsI	u
uchafbwyntiau	9Ji	4
uchafbwyntiau	BgvS	w
uchafrif	V2v	y
uchafrifau	Zo5	z
uchafswm	9L6	s
uchafsymiau	9LG	0
uchafsymiol	MnZ	m
uchder	9NW	n
uchderau	9Mm	w
uchel	i/F	c
ucheldir	9Ou	r
ucheldiroedd	9N9	x
uchelgais	9QU	u
uchelgeisiau	9PZ	7
uchelgeisiol	i/h	o
uchelseinydd	Gr6	7
uchelseinyddion	T43	/
uchod	jAJ	e
udain	CC3m	e
udo	CC4E	c
ufuddhau	CC4g	g
ugain	BXCm	q
ugeinfed	BXDQ	u
un	BWsW	a
un ar ddeg	BagG	r
un deg un	Bagx	r
unaidd	Mn/	h
unamserol	Mog	v
unarddeg	Baer	5
undeb	9R0	o
undebau	9RC	y
undod	9TG	i
undodau	9Sc	q
uned	9UP	g
unedau	9To	n
unedig	jAn	s
unedol	jBT	h
unfarn	BN4t	h
unfed	/cI	o
unffurf	BBd3	1
unfryd	BN8P	f
unfrydol	BN8u	v
uniaethu	CC5A	p
uniaith	jB0	l
unig	M7N	f
unig	apN	Z
unigol	BJwA	t
unigol	jCZ	l
unigolion	9Vc	t
unigolydd	BPCq	BC
unigolyddiaeth	BN+Y	3
unigolyddol	BPB2	0
unigolyn	9Uv	t
unigryw	jC+	j
union	jDh	g
union gywir	Bcs2	u
uniongred	BOiD	l
uniongyrchol	jEB	o
unioni	CC5p	k
unlled	MpP	l
unlledu	Bi+A	j
unlliw	Mp0	p
unman	jEp	h
uno	CC6N	a
unol	jFK	m
unoli	CC6n	i
unrhyw	jFw	a
unswydd	BOAW	x
unwaith	jGK	e
unwaith ac am byth	BN5O	BJ
urdd	BN6X	+
urddas	/Dk	x
urddasau	9WJ	x
urddasol	jGo	k
urddo	CC7J	i
utganu	CC7r	l
uwch	Mq6	e
uwch	Mqd	d
uwchben	Bctk	i
uwchben	jHM	l
uwchddefnyddiwr	EKu	9
uwchddefnyddwyr	REV	9
uwchdechnoleg	BN7V	6
uwchefrydiau	BOCB	1
uwchfarchnad	BOC2	v
uwchfarchnadoedd	BU6i	5
uwchlaw	jHx	n
uwcholwg	BZYt	BA
uwcholygon	Bep9	BF
uwchradd	jIY	j
uwchraddiad	BODl	0
uwchraddiadau	BU7b	3
uwchraddio	CC8Q	j
wado	CC8z	d
wal	Gtf	b
waldio	CC9Q	e
waled	Gt6	i
waledau	T7X	s
waliau	T6k	z
walio	CC9u	d
ward	BOEZ	k
wardiau	BU8S	n
warws	BOE9	t
warysau	BU85	t
wats	BcuG	z
watsys	BgwC	/
wedi	L1R	b
wedii luosi â	BaLj	u
wedyn	jI7	i
weindio	CC+L	k
weirio	CC+v	d
weiro	CC/M	b
weithiau	Mr5	g
wfftian	CC/n	e
wfftio	CDAF	h
whado	CDAm	f
wincian	CDBF	e
wincio	CDBj	d
wpsiau	N72	s
wrth	BB5g	V
wrth law	BbZa	s
wrth law	MsZ	k
wrth ymyl	Bcu5	n
wrth ymyl	LTD	p
wrthddatganoli	BOHA	BG
wrthi	jJd	e
wrtho	jJ7	e
wrthych	BBsY	m
wrthyf	jKZ	d
wrthym	jK2	d
wrthynt	jLT	h
wy	9Xj	j
wyau	9W6	p
wyddwn i ddim tan hynny	BOlF	BN
wylo	CDCA	b
wylofain	CDCb	h
wyna	CDC8	b
wyneb	EWo	h
wynebau	RR5	0
wynebfath	Wgv	BB
wynebfathau	aYk	BJ
wyneblasu	CDDX	l
wynebu	CDD8	b
wynebwerth	Gza	z
wynebwerthoedd	UBP	8
wynebynwyneb	BER9	t
wyth	BW5E	f
wyth deg	Bcvg	y
wythawd	G0N	m
wythdegau	BESq	x
wythfed	BW5j	o
wythnos	9Yr	f
wythnosau	9YG	l
wythnosol	jL0	i
wythodau	UCL	z
wythol	MuT	f
y	BCBt	T
y	BCJ+	8
y byd sydd ohoni	BOYP	9
y cyfryngau torfol	BNuD	BI
y farchnad rydd	BN/P	BH
y wladwriaeth les	BN9d	7
ych	9Zx	f
ychen	9ZK	n
ychwaith	jMW	i
ychwanegiad	BBPe	4
ychwanegiadau	BBOg	+
ychwanegion	acO	BT
ychwanegol	jM4	s
ychwanegu	CDEX	j
ychwanegyn	Wj6	BL
ychydig	9a+	l
ychydigion	9aQ	u
ydau	TQg	k
ydol	BOIG	l
yfed	CDE6	Z
yfory	jNk	h
ym	BCfl	m
ym mhle	XoV	x
ym mhobman	LoY	q
yma	jOF	i
ymachub	CDFT	p
ymadael	CDF8	i
ymadawedig	jOn	l
ymaddasol	HyS	s
ymaddasu	CDGe	o
ymadrodd	9cb	t
ymadrodd	C8l	p
ymadrodd	CDHG	h
ymadrodd parod	BdK6	BG
ymadrodd treuliedig	BdIL	9
ymadroddion	9bj	4
ymadroddion	Pu+	x
ymadroddion parod	Bg3L	9
ymadroddion treuliedig	Bg0S	BA
ymadu	CDHn	h
ymaelodi	CDII	v
ymaelyd	CDI3	m
ymafael	CDJd	h
ymaflyd	CDJ+	j
ymageru	CDKh	r
ymagor	CDLM	g
ymagwedd	9d+	r
ymagweddau	9dI	2
ymagweddu	CDLs	w
ymaith	jPM	Z
ymannerch	CDMc	i
ymannog	CDM+	w
ymanodi	CDNu	i
ymarfer	9fe	u
ymarfer	CDOQ	q
ymarferiad	9hB	s
ymarferiadau	9gM	1
ymarferion	9ep	1
ymarferol	jPl	v
ymarferoldeb	9iu	3
ymarferoldebau	9ht	BB
ymarferwr	9kk	4
ymarferwyr	9jl	/
ymarferydd	9mW	1
ymarferyddion	9lc	6
ymarweddu	CDO6	k
ymatal	CDPe	i
ymateb	9oB	u
ymateb	CDQA	l
ymatebion	9nL	2
ymatebol	jQU	l
ymatebolrwydd	HvF	/
ymatebwr	9pj	r
ymatebwyr	9ov	0
ymatebydd	BOJg	q
ymatebyddion	BU+r	7
ymawyddu	CDQl	h
ymbalfalu	CDRG	o
ymbaratoi	CDRu	l
ymbellhau	CDST	i
ymbelydru	CDS1	w
ymbesgi	CDTl	l
ymbil	CDUK	l
ymbilio	CDUv	l
ymbincio	CDVU	v
ymboeni	CDWD	n
ymborthi	CDWq	h
ymbriodi	CDXL	p
ymbrofi	CDX0	k
ymbwyllo	CDYY	m
ymchwarae	CDY+	l
ymchwil	9rC	u
ymchwiliad	9so	w
ymchwiliadau	9rw	4
ymchwilio	CDZj	r
ymchwilion	9qO	0
ymchwiliwr	9uR	x
ymchwilwyr	9tY	5
ymchwilydd	9v3	y
ymchwilyddion	9vC	1
ymchwydd	Uq3	7
ymchwyddion	YVI	BE
ymchwyddo	CDaO	k
ymdaclo	CDay	p
ymdaclu	CDbb	p
ymdaenu	CDcE	p
ymdaeru	CDct	k
ymdaflu	CDdR	g
ymdagu	CDdx	f
ymdannu	CDeQ	j
ymdaro	CDez	j
ymdawelu	CDfW	n
ymddadlau	CDf9	n
ymddangos	CDgk	j
ymddangosiad	9xl	0
ymddangosiadau	9wp	8
ymddangosiadol	jQ5	v
ymddatod	CDhH	j
ymddeol	CDhq	m
ymddeoliad	9zX	2
ymddeoliadau	9yZ	+
ymdderian	CDiQ	m
ymdderu	CDi2	k
ymddial	CDja	i
ymddiddan	CDj8	n
ymddiddori	CDkj	w
ymddieithrio	CDlT	x
ymddigrifo	CDmE	k
ymddihatru	CDmo	o
ymddiheuro	CDnQ	u
ymddilladu	CDn+	q
ymddiosg	CDoo	s
ymddiried	BBRY	6
ymddiried	CDpU	o
ymddiriedadwy	MwQ	2
ymddiriedaeth	91N	3
ymddiriedaethau	90N	BA
ymddiriedau	BBQW	BC
ymddiriedgar	MxG	x
ymddiriedig	Muy	5
ymddiriedol	Mvr	l
ymddiriedolaeth	BBTW	6
ymddiriedolaethau	BBSS	BE
ymddiriedolwr	93C	6
ymddiriedolwyr	92E	+
ymddiriedu	CDp8	r
ymddiswyddo	CDqn	u
ymddolennu	CDrV	n
ymddwyn	CDr8	l
ymddyfalu	CDsh	1
ymddygiad	943	3
ymddygiadau	938	7
ymddygiadol	BOIr	1
ymddyrchafu	CDtW	0
ymdebygu	CDuK	r
ymdecáu	CDu1	s
ymdeimlad	96o	v
ymdeimladau	95u	6
ymdeimlo	CDvh	l
ymdeithio	CDwG	r
ymdoddi	CDwx	l
ymdopi	CDxW	k
ymdrech	98O	r
ymdrechion	97X	3
ymdrechu	CDx6	l
ymdreiddio	CDyf	p
ymdreiglo	CDzI	l
ymdrin	CDzt	g
ymdrin â	Bj1Y	o
ymdriniaeth	BBVh	BI
ymdriniaethau	BBUQ	BR
ymdrinio	CD0N	l
ymdrochi	CD0y	l
ymdroi	CD1X	l
ymdrwsio	CD18	o
ymdrybaeddu	CD2k	o
ymdrythyllu	CD3M	w
ymdwyro	CD38	f
ymdynghedu	CD4b	j
ymdynnu	CD4+	r
ymdyrru	CD5p	o
ymegnïo	CD6R	j
ymehangu	CD60	u
ymeiriol	CD7i	m
ymeithrio	CD8I	k
ymelwa	Bi+j	l
ymelwad	WlF	/
ymelwadau	adh	BH
ymennydd	99o	n
ymenyddiau	985	v
ymerawdwr	BblA	3
ymerawdwyr	BgB+	4
ymerodraeth	G0z	0
ymerodraethau	UC+	6
ymerodres	Bbl3	t
ymerodresau	BgC2	7
ymerodrol	Bbmk	s
ymesgusodi	CD8s	y
ymestyn	Bid8	p
ymestyn	CD9e	l
ymestyniad	9/G	v
ymestyniadau	9+P	3
ymfalchïo	CD+D	u
ymfflamychu	CD+x	o
ymffrostio	CD/Z	s
ymffyrnigo	CEAF	j
ymfodloni	CEAo	r
ymfudo	CEBT	n
ymfyddino	CEB6	o
ymfywiocáu	CECi	u
ymgadw	CEDQ	n
ymgais	+Aw	w
ymgaledu	CED3	p
ymgartrefu	CEEg	5
ymgasglu	CEFZ	t
ymgecru	CEGG	l
ymgeisiau	9/1	7
ymgeisio	CEGr	m
ymgeiswyr	+CR	t
ymgeisydd	+Bg	x
ymgeleddu	CEHR	s
ymgelu	CEH9	s
ymgilio	CEIp	k
ymgiprys	CEJN	n
ymgladdu	CEJ0	u
ymgleddyfu	CEKi	k
ymglwyfo	CELG	q
ymglywed	CELw	k
ymgnawdoli	CEMU	z
ymgodi	CENH	m
ymgodymu	CENt	m
ymgofrestru	CEOT	y
ymgolli	CEPF	v
ymgom	aoM	BB
ymgomiau	aeo	BK
ymgomio	CEP0	l
ymgorffori	CEQZ	q
ymgreinio	CERD	s
ymgripio	CERv	l
ymgroesi	CESU	r
ymgrogi	CES/	u
ymgrymu	CETt	j
ymguddio	CEUQ	u
ymgurio	CEU+	o
ymgychwyn	Bhfk	8
ymgydio	CEVm	n
ymgydnabyddu	CEWN	y
ymgyfarwyddu	CEW/	4
ymgyfathrachu	CEX3	2
ymgyfeillachu	CEYt	0
ymgyffelybu	CEZh	8
ymgyfoethogi	CEad	4
ymgyfuno	CEbV	0
ymgymeriad	+D1	0
ymgymeriadau	+C+	3
ymgymryd	CEcJ	z
ymgynghori	CEc8	u
ymgynghori â	BZ0/	s
ymgynghoriad	+Fr	5
ymgynghoriadau	+Ep	BC
ymgynghorol	jRo	s
ymgynghorwr	+Hh	1
ymgynghorwyr	+Gk	9
ymgynghorwyr	BQEo	4
ymgynghorydd	+JR	2
ymgynghoryddion	+IW	7
ymgynghreirio	CEdq	7
ymgynhorydd	BDyr	w
ymgynnull	CEel	t
ymgyrch	+LD	z
ymgyrchoedd	+KH	8
ymgyrchu	CEfS	l
ymgyrchwr	BOKK	4
ymgyrchwyr	BU/m	u
ymgysegru	CEf3	z
ymgyweirio	CEgq	5
ymhalogi	CEhj	u
ymhelaethu	CEiz	y
ymhell	jSU	r
ymhellach	jS/	x
ymhellach gweler 	BbhO	8
ymhen	BONs	p
ymhen amser	BOOV	BI
ymherodr	BbkC	+
ymheulo	CEjl	s
ymhlith	jTw	f
ymhlyg	L1s	g
ymhlygu	Bisv	p
ymhob	BOPd	f
ymholi	BhYg	8
ymholi	CEkR	n
ymholiad	+Mp	p
ymholiad	WoI	2
ymholiadau	+L2	z
ymholiadau	aiA	BC
ymhongar	Bc5s	o
ymhyfrydu	CEk4	o
ymhél	CEiR	i
ymlacio	CElg	o
ymladd	+OE	n
ymladd	CEmI	h
ymladdau	+NS	y
ymlaen	Xv0	z
ymlaen	jUP	i
ymlaesu	CEmp	i
ymlafnio	CEnL	o
ymlafurio	CEnz	j
ymlawenhau	CEoW	j
ymlawenychu	CEo5	o
ymledu	CEqH	n
ymlenwi	CEqu	p
ymlid	CErX	n
ymliwio	CEr+	g
ymlusgo	CEse	h
ymlwybro	CEs/	q
ymlyn	CEtp	d
ymlyniad	BPHz	BA
ymlyniadau	BVMb	BL
ymlynu	CEuG	h
ymlâdd	CEph	m
ymneilltuo	CEun	o
ymnythu	CEvP	j
ymochel	CEvy	e
ymod	CEwQ	c
ymofyn	CEws	o
ymolchi	CExU	o
ymollwng	CEx8	l
ymorchestu	CEyh	h
ymorol	CEzC	f
ymosod	CEzh	g
ymosodiad	+Pb	n
ymosodiadau	+Or	w
ymosodol	Mzh	x
ymosodwr	G1n	w
ymosodwyr	UD4	v
ymostwng	CE0B	h
ymprydio	CE0i	m
ymrafael	BOQ2	r
ymrafaelio	CE1I	k
ymrafaelion	BVAU	y
ymrannu	CE1s	k
ymrestru	CE2Q	k
ymresymiad	WnO	6
ymresymiadau	ahA	BA
ymresymu	CE20	k
ymrithio	CE3Y	2
ymroddedig	jUx	l
ymroddgar	BORh	BN
ymroddi	CE4O	p
ymroddiad	jVW	r
ymroi	CE43	p
ymrwyfo	CE5g	s
ymrwymedig	jWB	w
ymrwymiad	+Q9	z
ymrwymiadau	+QC	7
ymrwymo	Bjs1	q
ymrwymo	CE6M	s
ymryson	CE64	k
ymsefydlu	CE7c	i
ymsennu	CE7+	i
ymserchu	CE8g	k
ymson	CE9E	l
ymsoni	CE9p	r
ymsuddo	CE+U	o
ymswyno	CE+8	p
ymsynio	CE/l	e
ymsythu	CFAD	i
ymuno	CFAl	g
ymwacáu	CFBF	p
ymwadu	CFBu	j
ymwaredu	CFCR	j
ymweld	CFC0	g
ymweledig	XvB	z
ymweliad	+Sk	p
ymweliadau	+Rw	0
ymwelwr	+UA	p
ymwelwyr	+TN	z
ymwelydd	+VY	q
ymwelyddion	+Up	v
ymwisgo	CFDU	g
ymwneud	Bj8i	y
ymwrando	CFES	x
ymwrthod	CFFD	i
ymwrthodiad	+W+	z
ymwrthodiadau	+WC	8
ymwthio	CFFl	j
ymwybodol	jWx	p
ymwybyddiaeth	jXa	9
ymyl	BCCA	h
ymyl	EpF	f
ymyleiddio	BjJ+	m
ymylol	jYX	p
ymylon	BCCh	g
ymylon	Rlu	p
ymylu	CFGI	c
ymyriad	+Yu	1
ymyriad	WNx	2
ymyriad ar breifatrwydd	G2X	BZ
ymyriadau	+Xx	9
ymyriadau	aC3	9
ymyriadau ar breifatrwydd	UEn	BT
ymyrraeth	Bc2+	x
ymyrraeth	jZA	6
ymyrru	BiHE	u
ymyrru	CFGk	n
ymyrryd	CFHL	m
ymysg	jZ6	e
ymysgwyd	CFHx	r
yn	BB9C	5
yn	BCdx	BG
yn	jaY	c
yn ddiymdroi	BNqm	3
yn ddiymyrraeth	BPKg	/
yn dra pherthnasol 	BP04	BC
yn ei amrywiol weddau	BZ3F	BG
yn eu gŵydd	BbWT	4
yn fras	BXmu	x
yn fras	Bcxf	r
yn gyfangwbl	LE5	v
yn gymysg â	BO99	1
yn hwyr neun hwyrach	M6U	5
yn llygad ei le	Bbud	BA
yn nhrefn yr wyddor	Mtf	0
yn sgil	BNBa	t
yn unsain	BETb	w
yn y bôn 8	BXkj	z
yn y naill gerdd ar ôl y llall	BPUB	BT
yn ystod	LV1	k
yn ôl	L40	r
yn ôl	L4T	h
yna	ja0	b
ynad	+aW	o
ynadon	+Zj	z
ynddi	BHf9	g
ynddi	jbP	Z
ynddo	BHgd	g
ynddo	jbo	a
ynddynt	jcC	g
ynfydu	CFIc	f
yng	BCgL	m
yngan	CFI7	i
ynganu	CFJd	k
ynghanol	BOSu	x
ynghlwm	jci	h
ynghyd	jdD	i
ynghylch	jdl	h
ynghynt	M1B	r
ynglŷn	jeG	f
ynni	+a+	m
yno	jel	c
ynof	jfB	c
yntau	jfd	X
ynteu	jf0	Y
ynycar	BD1S	e
ynys	+cu	k
ynysoedd	+cI	m
ynysu	CFKB	j
ynïau	+bk	k
yr	BCK6	BN
yr	BCgx	p
yr eiddoch yn gywir	KTp	BJ
yr wyddgrug	BOGa	m
ys	jgM	W
ysbaddu	CFKk	j
ysbarduno	CFLH	i
ysbeidiol	M1s	v
ysbeilio	CFMG	i
ysboncio	CFMo	l
ysbryd	+d/	j
ysbrydion	+dS	t
ysbrydol	jgi	k
ysbrydoli	CFNN	r
ysbrydoliaeth	BOTf	2
ysbrydoliaethau	BVBG	BI
ysbwylio	CFN4	h
ysbytai	+fN	r
ysbyty	+ei	r
ysbïo	CFLp	d
ysgafn	BBh3	1
ysgafnach	BcyK	p
ysgafnaf	Bcyz	w
ysgafnhau	CFOZ	n
ysgafnu	CFPA	k
ysgaldanu	CFPk	o
ysgaldian	CFQM	k
ysgall	N9s	n
ysgallen	BZS	r
ysgariad	+gk	q
ysgariadau	+f4	s
ysgarthu	CFQw	m
ysgaru	CFRW	i
ysgathru	CFR4	k
ysgeintio	CFSc	n
ysglefrio	CFTD	k
ysglyfaethu	CFTn	m
ysgogi	BjB3	h
ysgogi	CFUN	j
ysgogiad	+iC	r
ysgogiad	G3w	u
ysgogiadau	+hO	0
ysgogiadau	UF6	y
ysgol	+jh	p
ysgol	+k2	k
ysgolhaig	+mL	p
ysgolheictod	BOUV	8
ysgolheigion	+la	x
ysgolion	+it	0
ysgolion	+kK	s
ysgoloriaeth	BD1w	2
ysgoloriaethau	BQFg	BM
ysgothi	CFUw	o
ysgraffinio	CFVY	q
ysgrif	+nq	s
ysgrifau	+m0	2
ysgrifen	+pH	p
ysgrifenadwy	M3C	t
ysgrifenedig	M2b	n
ysgrifenedig	jhG	j
ysgrifennau	+oW	x
ysgrifennu	CFWC	t
ysgrifennwr	BWlw	x
ysgrifennydd	+qs	z
ysgrifenwyr	BWmh	q
ysgrifenyddion	+pw	8
ysgrytio	CFWv	l
ysgubo	CFXU	i
ysgubol	jhp	l
ysguborio	CFX2	0
ysgwrio	CFYq	o
ysgwyd	CFZS	i
ysgwydd	+sY	z
ysgwyddau	+rf	5
ysgwyddo	CFZ0	n
ysgydwo	CFab	n
ysgyfaint	+t5	o
ysgyfeiniau	+tL	u
ysgymuno	CFbC	q
ysgyrioni	CFbs	k
ysgyrnygu	CFcQ	l
ysgythru	CFc1	i
ysgytio	CFdX	o
ysgŵd	jiO	y
ysigo	CFd/	m
yslotian	CFel	q
ysmwddio	CFfP	j
ysmygu	CFfy	h
ystad	+vT	p
ystadau	+uh	y
ystadeg	+v8	t
ystadegaeth	Bczj	BA
ystadegau	BXD+	7
ystadegol	jjA	s
ystafell	+xR	q
ystafelloedd	+wp	o
ystelcian	CFgT	j
ystelcio	CFg2	i
ystlum	Wo+	6
ystlumod	ajC	BD
ystod	/C+	m
ystod	BDNj	6
ystodion	+x7	x
ystodion	BDMp	6
ystofi	CFhY	h
ystrad	BOVR	v
ystradau	BVCO	w
ystrydeb	BdJI	o
ystrydebau	Bg1S	BC
ystrydebu	CFh5	o
ystum	G56	l
ystumiau	UIv	/
ystumio	CFih	k
ystwyrian	CFjF	j
ystwyth	BOWA	s
ystwytho	CFjo	h
ystyfnigo	CFkJ	v
ystyr	+1L	r
ystyriaeth	+zk	0
ystyriaethau	+ys	4
ystyried	CFk4	l
ystyrio	CFld	l
ystyrlon	Bc0j	p
ystyrlon	jjs	l
ystyron	+0Y	z
ysu	CFmC	e
yswiriannau	+2j	t
yswiriant	+12	t
yswirio	CFmg	p
yswiriwr	BD2m	o
yswirwyr	BQGs	x
â	BB/q	m
â	atA	d
âi ben yn ei blu	BOfV	BA
ôl	FaT	d
ôl	L5f	a
ôldrywydd	Gpu	y
ôldrywyddion	T2V	2
ôlenedigol	BLiO	p
ôlfodern	BLi3	p
ôlfodern	BPmZ	p
ôlgofrestru	BLjg	9
ôlgydnaws	LIh	4
ôlgydnawsedd	Eg4	BI
ôlgydnawseddau	RdC	BG
ôlraddedig	BHwO	s
ôlraddedig	BHyo	7
ôlraddedigion	BR4G	9
ôlrestr	BLkd	2
ôlrestrau	BTuF	8
ôlweithredu	Bjla	9
ŵps	BYR	e
ŵps	IzD	Y
ŵyn	2wN	m
ŷd	GGA	d
