00databasealphabet	1Wp	l
00databasedictfmt1121	B	b
00databaseinfo	c	fi
00databaseshort	f+	s
00databaseurl	gq	V
00databaseutf8	A	B
a	g/	c
abbed	hb	Bk
abbedi	i/	o
abbedisse	jn	BJ
abdicere	kw	p
abdikation	lZ	x
abe	mK	d
abebestand	mn	BE
abebrødtræ	nr	8
abefest	on	m
abekat	pN	e
abekattestreger	pr	7
abemenneske	qm	s
abeunge	rS	o
abkhasien	r6	o
abkhasier	si	s
abnorm	tO	l
abnormitet	tz	w
abonnement	uj	y
abonnementsbillet	vV	BL
abonnent	wg	q
abonnere	xK	s
aborre	x2	k
abort	ya	f
abortere	y5	p
abraham	zi	o
abrikos	0K	r
abrupt	01	k
absces	1Z	c
abscisse	11	j
abscisseakse	2Y	9
absint	3V	e
absolut	3z	l
absolutisme	4Y	0
absolutist	5M	v
absolutistisk	57	4
absorbere	6z	p
absorbering	7c	0
abstinens	8Q	s
abstinenssymptomer	88	BH
abstrahere	+D	t
abstrakt	+w	k
abstraktion	/U	1
absurd	BAJ	e
absurditet	BAn	t
abyssiner	BBU	o
acceleration	BB8	3
accelerere	BCz	u
accent	BDh	BG
accentuere	BEn	x
accentuering	BFY	6
accept	BGS	g
acceptabel	BGy	r
acceptant	BHd	m
acceptere	BID	BA
acceptering	BJD	z
accessionskatalog	BJ2	BE
acetone	BK6	h
acetylen	BLb	m
achilles	BMB	h
achilleshæl	BMi	x
achillessene	BNT	y
acontobeløb	BOF	x
adam	BO2	U
adamsæble	BPK	x
addere	BP7	a
addis ababa	BQV	2
addition	BRL	n
adel	BRy	d
adelig	BSP	b
adelsbrev	BSq	1
adelsherredømme	BTf	BB
adelsmand	BUg	m
adelsmærke	BVG	r
aden	BVx	Z
adfærd	BWK	l
adfærdsforsker	BWv	4
adfærdsforskning	BXn	+
adfærdsforstyrrelse	BYl	BS
adfærdsmønster	BZ3	BF
adfærdspsykologi	Ba8	BH
adfærdsvanskelig	BcD	8
adgang	Bc/	4
adgangsbegrænsning	Bd3	BT
adgangsbillet	BfK	BL
adgangskode	BgV	Bj
adjektiv	Bh4	n
adjudant	Bif	p
adjø	BjI	b
adkomst	Bjj	i
adle	BkF	Y
adlyde	Bkd	a
administration	Bk3	BD
administrativ	Bl6	9
administrator	Bm3	7
administrere	Bny	w
admiral	Boi	o
admiralskib	BpK	z
admiralstab	Bp9	4
adonis	Bq1	g
adoptere	BrV	l
adoption	Br6	n
adoptionsbevilling	Bsh	BN
adoptivbarn	Btu	2
adrenalin	Buk	p
adressat	BvN	n
adresse	Bv0	h
adressebog	BwV	t
adressere	BxC	k
adrianopel	Bxm	r
adriaterhavet	ByR	BH
adræt	BzY	Z
adskille	Bzx	q
adskillelse	B0b	6
adskillige	B1V	k
adskilt	B15	g
adspredelse	B2Z	s
advare	B3F	l
advarsel	B3q	l
advent	B4P	c
adventskrans	B4r	5
adverbiel	B5k	q
adverbium	B6O	v
advis	B69	b
advisere	B7Y	l
advokat	B79	l
advokatpraksis	B8i	BB
advokatsalær	B9j	8
adzharien	B+f	p
adækvat	B/I	l
ae	B/t	S
aerodynamik	B//	5
aeromekanik	CA4	z
af	CBr	0
af og til	DcJ	o
af træ	Dcx	d
afart	CEA	a
afbalancere	CEa	v
afbarke	CFJ	c
afbenytte	CFl	l
afbenyttelse	CCf	s
afbestille	CDL	1
afbetale	CGK	k
afbetaling	CGu	x
afbilde	CHf	f
afbildning	CH+	w
afblege	CIu	g
afbrudt	CJO	m
afbryde	CJ0	By
afbrydelse	CLm	z
afbryder	CMZ	r
afbryderkontakt	CNE	BJ
afbrænde	CON	7
afbud	CPI	6
afbælge	CQC	e
afbøde	CQg	h
afbøje	CRB	g
afbøjning	CRh	q
afdampe	CSL	d
afdampning	CSo	t
afdansning	CTV	v
afdansningsbal	CUE	BS
afdeling	CVW	By
afdelingschef	CXI	BY
affaldsafgift	CYg	3
affaldsbeholder	CZX	Bz
affaldsbørs	CbK	BU
affaldscontainer	Cce	Bz
affaldsdeponering	CeR	BM
affaldsdepot	Cfd	7
affaldsgebyr	CgY	BS
affaldskurv	Chq	BH
affaldspose	Cix	v
affaldssortering	Cjg	CM
affaldsstof	Cls	y
affaldstræ	Cme	u
affyre	CnM	y
affære	Cn+	BE
afgang	CpC	h
afgangseksamen	Cpj	BD
afgangstid	Cqm	BK
afghaner	Crw	h
afghanerinde	CsR	y
afghanistan	CtD	y
afgrund	Ct1	6
afgud	Cuv	f
afgå	CvO	3
afgøre	CwF	i
afholdsmand	Cwn	w
afhænge	CxX	g
afhænge af	Cx3	BI
afhængig	Cy/	j
afhængig af	C0V	t
afhængighed	Czi	z
afhøre	C1C	3
afkøbe	C15	m
afkøle	C2f	0
afkøling	C3T	q
aflevere	C39	3
aflevering	C40	w
aflyse	C5k	BF
aflægge	C6p	5
aflægger	C7i	k
afløb	C8G	+
afløbsrør	C9E	BQ
afregne	C+U	r
afregning	C+/	1
afrejse	C/0	Bp
afrika	DBd	k
afrikaans	DCB	r
afrikander	DCs	y
afrikaner	DDe	t
afrikanerinde	DEL	+
afrikansk	DFJ	n
afroasiat	DFw	0
afrunde	DGk	o
afsende	DHM	BH
afsender	DIT	j
afsides	DI2	y
afskaffe	DJo	BT
afskaffelse	DK7	3
afsked	DLy	1
afskedige	DMn	8
afskedsord	DNj	2
afskrift	DOZ	x
afskrive	DPK	l
afskrivning	DPv	1
afsky	DQk	BT
afslå	DR3	b
afsløre	DSS	u
afsløring	DTA	v
afsnit	DTv	g
afstamme	DUP	BC
afstamning	DVR	u
afstand	DV/	q
aftale	DWp	Ba
aften	DYD	b
aftenavis	DYe	y
aftensmad	DZQ	1
afveksling	DaF	z
afvigelse	Da4	0
afvise	Dbs	d
agamemnon	DdO	u
agent	Dd8	c
agentur	DeY	o
agerhøne	DfA	p
agern	Dfp	3
aggression	Dgg	1
agte	DhV	o
agtelse	Dh9	s
agterstavn	Dip	6
agurk	Djj	j
agurketid	DkG	3
ahorn	Dk9	g
ahornsirup	Dld	w
ajax	DmN	Z
akacie	Dmm	e
akademi	DnE	n
akademiker	Dnr	x
akademisk	Doc	p
akeron	DpF	j
akkord	Dpo	j
akkumulator	DqL	BN
akrobat	DrY	n
aksel	Dr/	i
akt	Dsh	S
aktie	Dsz	d
aktindsigt	DtQ	BB
aktionsforskning	DuR	BE
aktiv	DvV	q
aktivitet	Dv/	2
aktstykke	Dw1	8
aktuel	Dxx	BQ
akvarel	DzB	r
akvarium	Dzs	r
alarm	D0X	e
alaska	D01	d
alba	D1S	T
albaner	D1l	l
albanien	D2K	j
albanierinde	D2t	7
albansk	D3o	w
albion	D4Y	f
albue	D43	b
albuerum	D5S	q
album	D58	b
alder	D6X	Z
alderdomshjem	D6w	8
aldrig	D7s	c
alene	D8I	v
alenlang	D83	p
aleppo	D+F	f
alexander	D+k	n
alexandria	D/L	s
alfabet	D/3	l
alfabetisk	EAc	u
alfahan	D9g	l
alfred	EBK	c
algerier	EBm	f
algerierinde	ECF	x
algeriet	EC2	n
algier	EDd	d
alibi	ED6	g
alkohol	EEa	n
alkoholfri	EFB	0
alkoholisk	EF1	r
allah	EGg	U
alle	EG0	S
allehelgensdag	EHG	BJ
allerede	EIP	u
allergisk	EI9	o
allesjælesdag	EJl	y
allé	EKX	X
almagt	EKu	k
almengyldig	ELS	y
almenkendt	EME	1
almennyttig	EM5	BA
almensprog	EN5	t
almindelig	EOm	B/
almisse	EQl	k
almægtig	ERJ	n
alpehytte	ERw	BG
alperne	ES2	g
alpinist	ETW	BL
alsacelorraine	EUh	8
alsakser	EVd	l
alt	EWC	o
altai	EWq	a
altan	EXE	c
alter	EXg	c
altid	EX8	g
altmuligmand	EYc	t
altæder	EZJ	o
aluminium	Eaf	7
alun	Eba	T
alvorlig	Ebt	BJ
alvorsmand	EZx	u
alvorsord	Ec2	1
amatør	Edr	s
amazone	EeX	e
amazonfloden	Ee1	/
ambassadør	Ef0	v
amboina	Egj	j
ambon	EhG	d
amboner	Ehj	j
ambulance	EiG	/
amerika	EjF	n
amerikaner	Ejs	BC
amerikanerinde	Eku	+
amerikansk	Els	r
amerikansk fodbold	EmX	BW
amerikansk samoa	Ent	BD
amfiteater	Eow	1
amman	Epl	X
ammunition	Ep8	2
amnesti	Eqy	v
ampul	Erh	Z
amputere	Er6	l
analsex	Esf	k
ananas	EtD	i
anarkist	Etl	m
anatomisk	EuL	q
anbefalet brev	Eu1	BC
anbefaling	Ev3	x
and	Ewo	Q
andebestand	Ew4	z
andefedt	Exr	k
andel	EyP	Y
andemad	Eyn	i
anden	EzJ	X
anden juledag	Ezg	x
andengradsligning	E0R	BL
andenudgave	E1c	3
anderledestænkende	E2T	BR
andetsteds	E3k	m
andorra	E4K	l
anførelsestegn	E4v	BV
angina	E6E	7
angive	E6/	8
angivelse	E77	BF
anglikansk	E9A	p
angola	E9p	e
angreb	E+H	w
angribe	E+3	n
angst	E/e	0
angstskrig	FAS	6
angå	FBM	Z
ankel	FBl	d
anker	FCC	b
anklage	FCd	c
ankomst	FC5	j
anledning	FDc	BJ
anliggende	FEl	BK
anlæg	FFv	+
anmelde	FGt	a
annonce	FHH	o
anonym	FHv	/
ansat	FIu	d
ansigt	FJL	e
ansjos	FJp	h
anskueliggøre	FKK	6
anslag	FLE	a
anstrengelse	FLe	q
ansvarlig	FMI	x
ansvarsfraskrivelse	FM5	BG
ansøger	FN/	k
antage	FOj	0
antal	FPX	f
antenne	FP2	p
antibiotikum	FQf	6
antigua og barbuda	FRZ	BQ
antik	FSp	j
antisemitisme	FTM	7
antiseptisk	FUH	t
anvende	FU0	m
apatisk	FVa	h
apostel	FV7	k
apotek	FWf	0
apoteker	FXT	o
apparat	FX7	2
appartement	FYx	1
appartementhus	FZm	BM
appelsin	Fay	n
appelsinhud	FbZ	z
appelsinjuice	FcM	7
appelsinskræl	FdH	6
appetit	FeB	l
applaus	Fem	k
april	FfK	b
aprilsnar	Ffl	o
apropos	FgN	j
araber	Fgw	g
arabisk	FhQ	r
arbejde	Fh7	m
arbejder	Fih	Bh
arbejderbi	FkC	x
arbejdsbord	Fkz	y
arbejdsdag	Fll	p
arbejdsgiver	FmO	z
arbejdsløs	FnB	t
arbejdsløshed	Fnu	8
arbejdsro	Foq	v
arbejdstager	FpZ	u
arena	FqH	d
argentina	Fqk	q
argentinier	FrO	u
aristokratisk	Fr8	7
arkitekt	Fs3	o
arkitektur	Ftf	2
arkiv	FuV	2
arkæologi	FvL	z
arm	Fv+	U
armbånd	FwS	k
armbåndsur	Fw2	z
armenien	Fxp	k
armhule	FyN	g
armstol	Fyt	h
armé	FzO	a
aroma	Fzo	n
aron	F0P	q
arrestere	F05	n
arrigtrold	F1g	s
art	F2M	X
arterie	F2j	l
artikel	F3I	u
artilleri	F32	r
artiskok	F4h	r
artist	F5M	Z
arv	F5l	Z
arve	F5+	Y
asiat	F6W	a
asiatisk	F6w	s
asien	F7c	a
ask	F72	Q
aske	F8G	b
askebæger	F8h	r
asketræ	F9M	h
asocial	F9t	r
asparges	F+Y	e
assistent	F+2	3
asters	F/t	e
astma	GAL	8
astmaanfald	GBH	v
astmapatient	GB2	6
astronaut	GCw	2
astronomi	GDm	x
asyl	GEX	0
asylansøger	GFL	0
atlanterhavet	GF/	BE
atlantisk	GHD	0
atlas	GH3	W
atlet	GIN	Z
atmosfærisk	GJP	y
atom	GKB	V
atomenergi	GKW	0
atomkerne	GIm	p
attaché	GLK	n
atten	GLx	Z
attende	GMK	f
attest	GMp	p
august	GNS	g
auktion	GNy	j
aula	GOV	BD
australien	GPY	t
australier	GQF	r
australsk	GQw	n
autodidakt	GRX	BD
automat	GSa	n
automatisk	GTB	s
automobil	GTt	n
autopsi	GUU	n
autor	GU7	d
autoritet	GVY	q
autoritetstro	GWC	BW
autoritær	GXY	x
avertere	GYJ	BB
avis	GZK	BM
avle	GaW	t
azalea	GbD	c
baby	Gbf	b
babyalarm	Gcs	7
babybio	Gdn	BN
babyble	Ge0	r
babyboom	Gff	r
babydukke	GgK	t
babyfløjl	Gg3	v
babylem	Ghm	q
babymad	GiQ	p
babymajs	Gi5	s
babypudder	Gjl	0
babysitter	Gb6	y
bacon	GkZ	Z
bad	Gky	S
bade	GlE	W
badebukser	Gla	1
badedragt	GmP	BA
badekar	GnP	f
badested	Gnu	i
badeværelse	GoQ	x
badmintonspiller	GpB	BH
bagage	GqI	q
bagagevogn	Gqy	BQ
bagbord	GsC	o
bagdad	Gsq	z
bagdør	Gtd	p
bage	GuG	U
bageovn	Gua	n
bager	GvB	a
bageri	Gvb	h
bagklog	Gv8	n
bagom	Gwj	b
bagtale	Gw+	f
bagtungevokal	Gxd	4
bahamaøerne	GyV	1
bahrain	GzK	k
bajonet	Gzu	l
bakke	G0T	m
bal	G05	c
balkon	G1V	e
ballast	G1z	b
ballon	G2O	h
balsam	G2v	h
bambus	G3Q	d
bamseknus	G3t	t
banan	G4a	b
bananrepublik	G41	8
bandage	G5x	i
bande	G6T	BF
bandeord	G7Y	1
bandit	G8N	f
banemand	G8s	n
bange	G9T	m
bangebuks	G95	w
bangladesh	G+p	v
bank	G/Y	Z
bankanvisning	G/x	7
banke	HAs	m
bankkonto	HBS	x
barak	HCD	n
barbados	HDm	o
barbermaskine	HCq	8
bare	HEO	n
bark	HE1	s
barm	HFh	Y
barmhjertighed	HF5	BG
barn	HG/	+
barnebarn	HH9	BI
barnesoldat	HJF	y
barnevogn	HJ3	1
barometer	HKs	u
barrikade	HLa	q
baryton	HME	j
basar	HMn	p
base	HNQ	f
baseball	HNv	j
basilika	HOS	l
basis	HO3	e
basketballkurv	HPV	BD
basketballspiller	HQY	BK
bast	HRi	T
batteri	HR1	n
beboer	HSc	j
bebrejde	HS/	BG
bebrejdelse	HUF	u
bed	HUz	T
bede	HVG	BC
bedemand	HWI	BD
bedrag	HXL	k
bedrage	HXv	q
bedrageri	HYZ	v
bedre	HZI	d
bedring	HZl	i
bedrøvet	HaH	BK
bedst	HbR	W
bedstefader	Hbn	y
bedsteforældre	HcZ	6
bedstemoder	HdT	s
bedømme	Hd/	z
befaling	Hey	u
befolkning	Hfg	s
befæste	HgM	BS
begejstring	Hhe	9
begge	Hjq	X
begivenhedshorisont	Hib	BP
begrave	HkB	0
begreb	Hk1	BM
begrebspar	HmB	0
begrebsramme	Hm1	/
begrebsverden	Hn0	9
begynde	Hox	x
begyndelse	Hpi	BE
begyndelsesværdiproblem	Hqm	Bj
behage	HsJ	c
behagelig	Hsl	BJ
behagelighed	Htu	0
behandle	Hui	BP
behandling	Hvx	n
beherske	HwY	9
beherske sig	HxV	3
beholde	HyM	BP
beholder	Hzb	BR
behov	H0s	i
behøve	H1O	m
bekende	H10	8
bekendelse	H2w	BF
bekendt	H31	j
bekendtgørelse	H4Y	Bp
bekendtskab	H6B	BJ
beklage	H7K	6
beklædning	H8E	7
bekræfte	H8/	+
bekvem	H99	i
belgien	H+f	l
belgier	H/E	g
belgierfranc	H/k	+
belgisk	IAi	g
belize	IBC	e
beløb	IBg	m
belønne	ICG	t
belønning	ICz	0
bemærkning	IDn	q
ben	IER	o
benarbejde	IE5	t
benin	IGU	e
benklæder	IFm	u
benytte	IGy	Ba
benyttelse	IIM	o
benzin	II0	1
benzinstation	IJp	BW
benzintank	IK/	4
benådning	INQ	BS
benægte	IL3	j
benævnelse	IMa	2
beregne	IOi	8
beregning	IPe	6
beretning	IQY	Bp
berlin	ISB	k
bermuda	ISl	n
beruset	ITM	u
berømt	IT6	1
berøre	IUv	j
berøring	IVS	o
besejre	IV6	w
besidde	IWq	q
besiddelse	IXU	v
beskadige	IYD	3
beskeden	IY6	4
beskrive	IZy	p
beskrivelse	Iab	8
beskytte	IbX	n
beskyttelse	Ib+	x
beskæftigelse	Icv	BF
beslutning	Id0	t
beslutte	Ieh	l
bestemme	IfG	2
bestemmelse	If8	y
bestik	Igu	l
bestille	IhT	v
bestilling	IiC	p
bestræbe sig	Iir	BW
bestyrer	IkB	v
besvær	Ikw	k
besætte	IlU	p
besættelse	Il9	u
besøge	Imr	y
betale	Ind	Z
betaling	In2	m
betalingsmiddel	Ioc	BK
betegnelse	Ipm	BW
betingelse	Iq8	BC
betjening	Ir+	/
beton	Is9	f
betoning	Itc	x
betyde	IuN	t
betydning	Iu6	r
betænkningstid	Ivl	+
beundre	Iwj	i
bevare	IxF	m
bevidsthed	Ixr	6
bevidstløs	Iyl	u
bevis	IzT	9
bevisbyrde	I0Q	BI
bevise	I1Y	c
bevægelig	I10	m
bevægelse	I2a	s
bevægelsesfrihed	I3G	BL
bevæggrund	I4R	6
beværtning	I5L	u
bi	I55	Q
biavler	I6J	6
bibel	I7D	Z
bibliotek	I7c	m
bid	I8C	U
bide	I8W	X
bidrage	I8t	m
bifald	I9T	y
bikini	I+F	f
bil	I+k	S
bilag	I+2	9
bilist	I/z	d
billard	JAQ	l
bille	JA1	Z
billede	JBO	BC
billet	JCQ	n
billethul	JC3	s
billig	JDj	n
biluheld	JEK	r
bilulykke	JE1	y
bilvask	JFn	k
bilvej	JGL	r
bind	JG2	q
binde	JHg	y
bindegal	JIS	x
bindeord	JJD	s
biograf	JJv	0
biord	JKj	h
birk	JLE	Z
biskop	JLd	e
bitter	JL7	l
bjerg	JMg	d
bjælke	JM9	i
bjørn	JNf	c
bjørnebestand	JN7	/
bjørneklo	JO6	BB
bjørnetjeneste	JP7	BN
blad	JRI	b
blande	JRj	u
blanding	JSR	q
bleg	JS7	c
blik	JTX	1
blind	JUM	X
blind person	JUj	/
blindhed	JVi	k
blindtarm	JWG	m
blive	JWs	BV
blive forbavset	JYB	BG
blod	JZH	b
blod	JZi	X
blodbad	JZ5	w
blodcelle	Jap	r
blodkredsløb	JbU	BD
blodlegeme	JcX	v
blodplade	JdG	q
blok	Jdw	c
blokade	JeM	i
blomkål	Jeu	l
blomme	JfT	e
blomst	Jfx	n
blomsterbuket	JgY	2
blond	JhO	f
blot	Jht	p
blotlægge	JiW	z
bluse	JjJ	c
bly	Jjl	T
blyant	Jj4	b
blå	Jou	c
blåbær	JpK	n
blåhval	Jpx	l
blåskimmelost	JqW	5
blåtand	JrP	j
blæk	JkT	U
blækklat	Jkn	v
blæksprutte	JlW	BA
blænde	JmW	b
blære	Jmx	k
blæse	JnV	Y
blæsebælg	Jnt	p
blød	JoW	Y
bo	Jry	BU
bo på værelse	JtG	7
bo sammen	JuB	1
boaslange	Ju2	t
boer	Jvj	i
boersprog	JwF	p
bog	Jwu	S
bogbus	JxA	k
boghandel	Jxk	t
boghandler	JyR	p
bogholder	Jy6	q
bogklub	Jzk	l
bogorm	J0J	k
bogskab	J0t	e
bogstav	J1L	d
bokser	J1o	d
bold	J2F	W
boldspil	J2b	o
bolig	J3D	7
bolleven	J3+	/
bolsje	J49	d
bombe	J5a	Y
bomuld	J5y	d
bonde	J6P	m
bondegård	J61	/
bondeknold	J70	q
bonderøv	J8e	p
bonusmor	J9H	w
bopæl	J93	BU
bor	J/L	W
bord	J/h	c
borddame	J/9	BS
borddug	KBP	q
bordel	KDR	j
bordherre	KB5	BY
bordlampe	KD0	u
bordtennis	KEi	+
bore	KFg	a
borger	KF6	r
borgerjournalistik	KGl	BQ
borgerkrig	KH1	u
borgmester	KIj	BE
bort	KJn	k
bortadoptere	KKL	BE
botanik	KLP	j
botniske bugt	KLy	+
bouillon	KMw	l
bov	KNV	X
bovbølge	KNs	p
brandbil	KOV	r
brandbombe	KPA	w
brasilianer	KPw	z
brasilien	KQj	n
bred	KRK	Z
bredbånd	KRj	s
bredde	KSP	c
bregne	KSr	d
bremse	KTI	3
brev	KT/	Z
brevkasse	KUY	v
brevkort	KVH	l
brevpapir	KVs	x
brigade	KWd	l
briket	KXC	a
briller	KXc	u
bringe	KYK	l
briste	KYv	p
brite	KZY	d
britisk	KZ1	p
britisk østafrika	Kae	Cn
bro	KdF	c
broche	Kdh	k
brochure	KeF	+
broder	KfD	g
broderdatter	Kfj	t
brodersøn	KgQ	r
brokke	Kg7	f
brombær	Kha	p
bronze	KiD	h
bror	Kik	e
brud	KjC	2
brudepige	Kj4	t
brudgom	Kkl	p
brudstykke	KlO	3
brug	KmF	U
bruge	KmZ	w
brugerbetaling	KnJ	BL
brugerbidrag	KoU	+
brugerdiskussionsside	KpS	BP
brugernavn	Kqh	t
brugerside	KrO	u
brumme	Kr8	l
brun	Ksh	Z
brusebad	Ks6	i
bryde	Ktc	b
bryde sig om	Kt3	/
bryllup	Ku2	z
bryst	Kvp	v
brystvorte	KwY	v
brække	KxH	d
brænde	Kxk	c
brændenælde	KyA	q
brændpunkt	Kyq	l
brændsel	KzP	g
bræt	Kzv	d
brød	K0M	m
brødflov	K0y	r
brødrister	K1d	1
brønd	K2S	f
bud	K2x	6
budding	K3r	k
bue	K4P	a
bueskytte	K4p	s
buffet	K5V	X
bug	K5s	l
bughule	K6R	r
bugserbåd	K68	u
bugt	K7q	j
bukser	K8N	p
buksevand	K82	BO
bundalvorlig	K+E	BE
bundfald	K/I	l
bur	K/t	W
burgerbar	LAD	s
bus	LAv	o
busk	LBX	g
buskort	LB3	l
busstation	LCc	v
busstoppested	LDL	1
butik	LEA	q
by	LEq	X
bydeform	LFB	p
bydel	LFq	BP
bydelstat	LG5	BO
byforny	LIH	s
byfornyelse	LIz	2
byg	LJp	W
bygge	LJ/	k
byggeplads	LKj	9
bygkorn	LLg	x
bygmester	LMR	Bd
bygning	LNu	m
byrde	LOU	r
bytte	LO/	j
bytur	LPi	l
bzer	LQH	e
båd	Lue	Y
både	Lu2	X
bådhus	LvN	l
bånd	Lvy	b
båndoptager	LwN	2
båre	LxD	h
bæger	LQl	o
bæk	LRN	Z
bælte	LRm	k
bænk	LSK	6
bær	LTE	b
bære	LTf	e
bæverbestand	LT9	+
bæverbo	LU7	s
bæveregern	LVn	7
bævergnavet	LWi	7
bæverhytte	LXd	y
bæverrotte	LYP	r
bæverstok	LY6	z
bøde	LaQ	X
bøf	Lan	h
bøffel	LbI	e
bøg	Lbm	W
bøhmand	LZt	j
bøje	Lb8	4
bøje sig	LdV	t
bøjet	Lc0	h
bølge	LeC	a
bølgebryder	Lec	4
bølgefunktion	LfU	7
bøn	LgP	Y
bønne	Lgn	Z
bønskrift	LhA	p
børnearbejde	Lhp	8
børnebidrag	Lil	+
børnehave	Ljj	z
børnehjem	LkW	u
børneporno	LlE	+
børnepornografi	LmC	BQ
børnesoldat	LnS	6
børnesygdom	LoM	BA
børnetøj	LpM	0
børs	LqA	j
børste	Lqj	g
bøsse	LrD	Y
bøssebar	Lrb	m
bøssekarl	LsB	n
bøssepest	Lso	v
bøsserøv	LtX	BH
café	Lxk	x
camping	LyV	x
campingvogn	LzG	w
carbondioxid	Lz2	BC
carbonkredsløb	L04	9
carbonmonoxid	L11	BE
cdafspiller	L25	4
celle	L3x	W
cellekerne	L4H	v
cellelære	L42	s
cellevæg	L5i	p
cement	L6L	f
censur	L6q	k
centimeter	L7O	w
central	L7+	g
centralnervesystem	L8e	BU
centralvarme	L9y	4
centrum	L+q	i
ceremoni	L/M	t
champagne	L/5	p
champignon	MAi	x
chauffør	MBT	BB
chef	MCU	2
chokolade	MDK	v
chokoladekage	MD5	9
cigar	ME2	d
cigaret	MFT	n
cigaretbukser	MF6	+
cigaretetui	MG4	8
cigaretmærke	MH0	9
cigaretpakke	MIx	4
cigaretpapir	MJp	BN
cigaretrygning	MK2	BD
cigaretrør	ML5	8
cigaretskod	MM1	5
cigaretsælger	MNu	BF
cigarettænder	MOz	BS
cirkel	MQF	j
cirkelafsnit	MQo	/
cirkeludsnit	MRn	/
cirkus	MSm	k
citadel	MTK	k
citere	MTu	i
citron	MUQ	h
citrongul	MUx	q
civil	MVb	z
civilstand	MWO	s
cognac	MW6	p
computer	MXj	l
computerproducent	MYI	BL
computerspil	MZT	z
cowboybukser	MaG	w
curiepunkt	Ma2	0
curietemperatur	Mbq	BM
cykel	Mc2	s
cykeldæk	Mdi	r
cykelhjul	MeN	r
cykelpumpe	Me4	w
cykelslange	Mfo	x
cykelstyr	MgZ	2
cylinder	MhP	w
cypres	Mh/	j
da	Mii	P
daddel	Mix	c
dadle	MjN	z
dag	MkA	U
dagbog	MkU	f
daggry	Mkz	r
daglig	Mle	b
dagligstue	Ml5	+
dal	Mm3	X
dam	MnO	X
dame	Mnl	Y
damp	Mn9	l
dampskib	Moi	8
damspil	Mpe	l
danmark	MqD	i
danne	Mql	c
danser	MrB	f
danserinde	Mrg	r
dansk	MsL	d
dansk kvinde	Mso	w
dansker	MtY	f
danskvand	Mt3	q
datid	Muh	h
dato	MvC	a
datolinje	Mvc	s
datter	MwI	c
datterkerne	Mwk	3
dav	Mxb	T
davs	Mxu	V
daværende	MyD	m
ddr	Myp	o
de forenede stater	MzR	BX
debat	M0o	b
december	M1D	m
defekt	M1p	d
deficit	M2G	k
definitionsmængde	M2q	+
dekan	M3o	b
dekoration	M4D	BW
del	M5Z	h
dele	M56	n
delegation	M6h	v
delegeret	M7Q	BD
delfin	M8T	i
delgraf	M81	l
delmængde	M9a	o
dels	M+C	i
delstat	M+k	n
delstatsparlament	M/L	BE
delstatsregering	NAP	BJ
deltage	NBY	1
deltagelse	NCN	q
deltagelsesdemokrati	NC3	Ba
delvis	NER	p
demokrati	NE6	w
demokratisk	NFq	y
den	NGc	Q
dens	NGs	T
dependensgrammatik	NG/	BM
deponeringsplads	NIL	BJ
deprimeret	NJU	u
der	NKC	m
derefter	NKo	+
deres	NLm	W
derfor	NL8	x
derfra	NMt	s
derhen	NNZ	4
deri	NOR	q
derned	NO7	s
dernede	NPn	r
derop	NQS	m
deroppe	NQ4	q
derpå	NRi	1
derunder	NSX	8
desinficere	NTT	w
desperat	NUD	n
dessert	NUq	l
desuden	NVP	BL
desværre	NWa	/
det	NXZ	j
det at rejse	NX8	r
det er en skam	NZe	Bs
detektiv	NYn	m
dets	NZN	R
dialekt	NbK	m
diamant	Nbw	k
diameter	NcU	r
diarré	Nc/	k
did	Ndj	+
differenskvotient	Neh	BG
differensrække	Nfn	BE
differentialkvotient	Ngr	BK
differentialligning	Nh1	BT
dig	NjI	Y
dige	Njg	j
digt	NkD	W
digter	NkZ	g
digtning	Nk5	i
din	Nlb	R
direktør	Nls	3
dirigent	Nmj	p
disciplin	NnM	u
diskos	Nn6	p
diskursanalyse	Noj	BF
diskussion	Npo	s
diskussionsforum	NqU	BH
diskussionsside	Nrb	6
distrikt	NsV	o
dit	Ns9	R
diæt	NtO	X
djævel	Ntl	c
dobbelt	NuB	i
dobbeltseng	Nuj	t
dok	NvQ	Y
doktor	Nvo	e
dokument	NwG	r
dolk	Nwx	c
dom	NxN	c
dominoeffekt	Nxp	9
domkirke	Nym	t
dommer	NzT	g
donkraft	Nzz	k
dosis	N0X	b
doven	N0y	X
drabantby	N1J	v
drager	N14	h
dragt	N2Z	q
drama	N3D	Y
drejebænk	N3b	j
dreng	N3+	n
drengekæreste	N4l	2
drengelus	N5b	t
drengerøv	N6I	m
drik	N6u	l
drikke	N7T	b
drikkepenge	N7u	p
droge	N8X	Y
dronning	N8v	n
druesukker	N9W	v
drukken	N+F	p
drukne	N+u	b
druknedød	N/J	3
drukspil	OAA	s
dræbe	OAs	q
drøftelse	OBW	q
drømme	OCA	d
due	OCd	e
dug	OC7	X
dum	ODS	l
dun	OD3	e
dusin	OEV	e
dværg	OEz	0
dyb	OFn	d
dybde	OGE	Z
dybhav	OGd	m
dybsindig	OHD	8
dygtig	OH/	n
dykke	OIm	r
dynamit	OJR	n
dynd	OJ4	Y
dyr	OK4	BG
dyr	OKQ	o
dyrebestand	OL+	3
dyrke	OM1	l
dyrlæge	ONa	t
dyrskue	OOH	t
dårlig	OQn	4
dårligt	ORf	k
dåse	OSD	Z
dåseoplukker	OSc	BD
dåseøl	OTf	p
dæk	OO0	q
dække	OPe	c
dæmning	OP6	t
dø	OUI	l
død	OUt	i
dødelig	OVP	g
dødfødsel	OVv	w
dødfødt	OWf	s
dødningehoved	OXL	8
dødsannonce	OYH	y
dødsattest	OY5	3
dødsdom	OZw	v
dødsdømme	Oaf	3
dødsdømt	ObW	4
dødsengel	OcO	y
dødsfjende	OdA	x
dødsforagt	Odx	9
dødsfrygt	Oeu	0
dødshjælp	Ofi	z
dødsmetal	OgV	x
dødsrige	OhG	BQ
dødsstraf	OiW	BF
dødssyg	Ojb	r
dødstrussel	OkG	1
dødsårsag	Ok7	1
dødsønske	Olw	x
dødvægt	Omh	t
dømme	OnO	2
dør	OoE	Y
dørklokke	Ooc	v
dørmand	OpL	v
dørmåtte	Op6	t
dørtrin	Oqn	y
døv	OrZ	V
døvstum	Oru	n
ebbe	OtT	d
ed	Otw	W
edderkop	OuG	q
edderkoppeben	Ouw	5
edderkoppespind	Ovp	8
eddikesur	OxI	q
edikke	Owl	j
efter	Oxy	h
efterchok	OyT	v
efterfølge	OzC	w
efterhånden	Ozy	/
efterlade	O0x	r
efterligne	O1c	z
efterligning	O2P	w
eftermiddag	O2/	v
efternavn	O3u	BD
efterskælv	O4x	x
eftertanke	O5i	8
eftertid	O6e	s
efterår	O7K	n
eg	O7x	U
egen	O8F	e
egennavn	O8j	r
egenskab	O9O	v
egentlig	O99	f
egern	O+c	f
egernbestand	O+7	9
egetræ	O/4	q
egnethed	PAi	k
egoistisk	PBG	9
eje	PCD	c
ejendom	PCf	BD
ejendommelig	PDi	BC
ejendomsmægler	PEk	5
ejer	PFd	Y
ekko	PF1	a
eksempel	PGP	l
eksempelsætning	PG0	BC
eksemplar	PH2	l
eksil	PIb	b
eksistens	PI2	o
eksistere	PJe	n
eksperiment	PKF	t
eksplodere	PKy	q
eksplosion	PLc	t
eksprestog	PMJ	Bp
ekstra	PNy	n
ekstrem	POZ	e
elastisk	PO3	j
elefant	PPa	i
elefantvæddeløb	PP8	BB
elegant	PQ9	e
elektricitet	PRb	0
elektrisk	PSP	m
elektronisk	PS1	w
elektronvolt	PTl	6
element	PUf	i
elementær	PVB	3
elendighed	PV4	m
elevator	PWe	r
elfenben	PXJ	k
elkedel	PXt	t
eller	PYa	V
ellers	PYv	e
elleve	PZN	a
elm	PZn	R
elsasser	PbB	j
elsasslothringen	PZ4	BJ
elske	Pbk	o
elskværdig	PcM	+
elvte	PdK	a
embede	Pdk	1
embedsmand	PeZ	BE
emblem	Pfd	c
emne	Pf5	v
en	Pgo	c
en gang	P6N	n
en og tyve	P60	q
end	PhE	R
ende	PhV	b
endelig	Phw	z
endelse	Pij	l
endestation	PjI	6
endetarm	PkC	i
endetarmsåbning	Pkk	6
endnu	Ple	f
endnu ikke	Pl9	p
enebarn	Pmm	l
enebær	PnL	q
energi	Pn1	k
energibevarelse	PoZ	BP
energisk	Ppo	p
eneste	PqR	b
enevælde	Pqs	w
eng	Prc	U
engang	Prw	k
engel	PsU	Y
engelsk	Pss	1
england	Pth	g
englænder	PuB	4
englænderinde	Pu5	/
englærke	Pv4	s
enhed	Pwk	m
enhedsmatrix	PxK	+
enhedsvektor	PyI	6
enighed	PzC	5
enke	Pz7	a
enkefrue	P0V	n
enkelt	P08	s
enkelthed	P1o	m
enkeltlyd	P2O	v
enkemand	P29	k
enlig	P3h	m
enorm	P4H	d
ensian	P4k	g
ensproget	P5E	v
ental	P7e	e
entré	P5z	a
epoke	P78	j
epostadresse	OsV	+
er	P8f	q
erfaring	P9J	p
erhverv	P9y	+
erhvervelse	P+w	BF
erhvervs	P/1	v
erhvervsaffaldsgebyr	QAk	BT
erindring	QB3	7
erklære	QCy	r
erobre	QDd	j
es	QEA	U
et	QEU	a
etage	QEu	t
etiket	QFb	f
europa	QF6	y
europæer	QGs	v
europæisk	QHb	u
europæisk union	QIJ	BK
evangelisk	QJT	x
eventyr	QKE	q
evne	QKu	d
fabel	QLL	b
fabrik	QLm	j
fabrikere	QMJ	2
facade	QM/	h
fader	QNg	e
fadervor	QN+	u
fadøl	QOs	h
fag	QPN	BN
fagforening	QQa	Bi
fagfællebedømmelse	QR8	BL
fagsprog	QTH	Bn
fakkel	QUu	a
faktisk	QVI	Bh
faktum	QWp	a
fakultet	QXD	k
fald	QXn	W
falde	QX9	b
faldgrube	QYY	t
faldskærm	QZF	q
faldskærmsjæger	QZv	+
faldskærmssoldat	Qat	9
falk	Qbq	Z
falsk	QcD	W
familie	QcZ	i
fane	Qc7	i
fange	Qdd	r
fangst	QeI	k
fantasi	Qes	k
far	QfQ	X
farbror	Qfn	7
fare	Qgi	0
farlig	QhW	d
farmand	Qhz	d
fart	QiQ	Y
farve	Qio	2
farvel	Qje	2
farvel så længe	QkU	BD
farvestof	QlX	7
fasan	QmS	d
fast	Qp4	BI
fastboende	Qmv	q
faster	QrA	x
fastland	Qrx	t
faststoffysiker	QnZ	BN
fastsætte	Qom	BS
fattig	Qse	i
fattigdom	QtA	l
fattigrøv	Qtl	m
feber	QuL	k
februar	Quv	q
fed	QvZ	i
fedt	Qv7	b
fedterøv	QwW	3
fedtsyre	QxN	q
feje	Qx3	X
fejekost	QyO	h
fejhed	Qyv	h
fejl	QzQ	r
fejlfarve	Qz7	x
fejre	Q0s	g
fejre fødselsdag	Q1M	BM
feltarbejde	Q2Y	x
feltflaske	Q3J	BC
fem	Q4L	S
femsproget	Q4d	x
femte	Q5O	Y
femten	Q5m	c
femtende	Q6C	i
femteudgave	Q6k	5
fennikel	Q7d	i
ferie	Q7/	8
fernis	Q87	g
fersken	Q9b	j
ferskvand	Q9+	r
fertilitetskvotient	Q+p	BF
fertilitetsrate	Q/u	BD
fest	RAx	w
feste	RBh	c
festmåltid	RB9	z
figen	RCw	c
figur	RDM	BK
fil	REW	X
filateli	REt	+
filial	RFr	7
film	RGm	v
filmfotograf	RHV	+
filmhold	RIT	o
filmproduktion	RI7	9
filmskole	RJ4	r
filt	RKj	Z
filter	RK8	h
filtrere	RLd	j
finale	RMA	9
finanslov	RM9	Bb
finde	ROY	X
finger	ROv	f
fingerbøl	RPO	s
fingernegl	RP6	v
fingerspids	RQp	v
finland	RRY	h
finne	RR5	h
finsk	RSa	a
finskåren	RS0	z
finskåret	RTn	2
firben	RUd	k
fire	RVB	T
firkant	RVU	o
firkantet	RV8	m
firma	RWi	n
firs	RXJ	e
firsproget	RXn	2
fisefornem	RYd	6
fisk	RZX	Z
fiske	RZw	c
fiskebestand	RaM	4
fiskehandler	RbE	z
fiskeolie	Rb3	p
fiskerbåd	Rcg	y
fiskestang	RdS	v
fjeder	ReB	w
fjeldabe	Rex	l
fjende	RfW	l
fjendebillede	Rf7	2
fjendskab	Rgx	f
fjer	RhQ	b
fjerde	Rhr	Z
fjerdedel	RiE	k
fjerdeudgave	Rio	5
fjerne	Rjh	4
fjernsyn	RkZ	v
fjernsynsapparat	RlI	BK
fjorten	RmS	j
fjorten dage	Rne	8
fjortende	Rm1	p
fjumreår	Roa	r
flad	RpF	p
flademål	Rpu	j
fladlus	RqR	m
flag	Rq3	f
flagermus	RrW	k
flamme	Rr6	e
flammekaster	RsY	2
flaske	RtO	e
flaskehals	Rts	q
flaskepost	RuW	2
flere	RvM	Z
flertal	Rvl	i
flid	RwH	a
flimmerkasse	Rwh	y
flink	RxT	6
flip	RyN	X
flise	Ryk	W
flittig	Ry6	7
flod	Rz1	m
flodhest	R0b	r
flonel	R1G	b
flue	R1h	h
flueknepperi	R2C	+
fluepapir	R3A	/
fluesmækker	R3/	0
flugt	R4z	n
flyde	R5a	X
flydende	R5x	o
flygte	R6Z	l
flytning	R6+	n
flytte	R7l	a
flyttebil	R7/	u
flyttemand	R8t	m
flyttevogn	R9T	BT
flyve	R+m	W
flyvemaskine	R+8	BN
flåde	SGh	e
fløde	SAJ	a
flødebolle	SAj	Cn
flødeis	SDK	o
flødekaramel	SDy	8
flødeskum	SEu	v
fløjte	SF+	j
fløjte	SFd	h
fod	SG/	Y
fodbold	SHX	n
fodboldspiller	SH+	Bc
foderstof	SJa	p
fodgænger	SKD	x
fodjonglør	SK0	5
fodkold	SLt	x
fodre	SMe	l
fodsål	SND	g
fold	SNj	r
folde	SOO	Y
folk	SOm	q
folkeafstemning	SPQ	+
folkeeventyr	SQO	BA
folkehøjskole	SRO	BA
folkemord	SSO	t
folkeret	SS7	7
folkeretsekspert	ST2	BT
folkeretsforsker	SVJ	BW
folketinget	SWf	BO
fontæne	SXt	n
for	SYU	3
for siden	SZL	p
foragt	SZ0	g
foragte	SaU	i
forandre	Sa2	2
forbavselse	Sbs	BG
forberede	Scy	q
forbi	Sdc	z
forbigangen	SeP	BC
forbinde	SfR	1
forbindelse	SgG	w
forblive	Sg2	x
forbogstav	Shn	s
forbrydelse	SiT	w
forbrænding	SjD	v
forbyde	Sjy	p
forbøn	Skb	p
fordampe	SlE	l
fordel	Slp	p
fordelagtig	SmS	u
fordele	SnA	k
fordeler	Snk	o
fordeling	SoM	r
fordi	So3	BD
fordoble	Sp6	j
fordom	Sqd	h
fordomsfuld	Sq+	+
fordre	Sr8	z
fordøje	Ssv	g
fordøjelse	StP	q
fordømme	St5	h
foredrag	Sua	p
foregive	SvD	+
forekomme	SwB	B7
forel	Sx8	c
forelske sig	SyY	1
foreløbig	SzN	3
forene	S0E	h
foreningsmængde	S0l	3
forestille	S1c	u
foretage	S2K	h
foretrække	S2r	n
forfald	S3S	r
forfatningsbrud	S39	BL
forfatningssikret	S5I	BW
forfatningsstridig	S6e	Bs
forfatter	S8K	u
forfængelig	S84	9
forfængelighed	S91	0
forfærdelig	S+p	CS
forfølge	TA7	BB
forgifte	TB8	j
forgæves	TCf	k
forhen	TDD	x
forhindre	TD0	BD
forhold	TE3	u
forholdsord	TFl	0
forhud	TGZ	k
forklare	TG9	7
forklaring	TH4	1
forkorte	TIt	BG
forkæle	TJz	t
forkælet	TKg	k
forkølelse	TLE	l
forkørselsret	TLp	8
forlade	TMl	+
forlegen	TNj	5
forlove sig	TQR	y
forlove sig med	TRD	B0
forlovede	TOc	BA
forlovelse	TPc	1
forlægger	TS3	u
form	TTl	c
formel	TUB	f
formelenhed	TUg	5
formgenre	TVZ	BO
formular	TWn	q
formål	TXR	1
formålstjenlig	TYG	6
fornavn	TZA	BD
forneden	TaD	4
fornemmelse	Ta7	o
fornuft	Tbj	BL
fornuftig	Tcu	BU
forny	TeC	a
fornyelsesproces	Tec	BA
fornærme	Tfc	0
fornærmelse	TgQ	v
fornøjelse	Tg/	u
forplejning	Tht	o
forretningsmand	TiV	4
forråde	TjN	s
forsamles	Tj5	BA
forsamling	Tk5	BI
forsigtig	TmB	y
forsigtighed	Tmz	x
forsikre	Tnk	t
forsikring	ToR	v
forsikringsselskab	TpA	BJ
forskel	TqJ	i
forskellig	Tqr	o
forskelsbehandle	TrT	+
forskningschef	TsR	BT
forskrække	Ttk	+
forspil	Tui	l
forstad	TvH	i
forstyrre	Tvp	BC
forstå	TxT	q
forstærke	Twr	o
forsvar	Tx9	o
forsvare	Tyl	h
forsvinde	TzG	n
forsvindelse	Tzt	y
forsætligt	T0f	3
forsøg	T1W	s
forsøge	T2C	y
forsøgsopstilling	T20	BN
forsømme	T4B	k
fortegn	T4l	h
fortid	T5G	c
fortjene	T5i	BN
fortov	T6v	o
fortovscafé	T7X	2
fortryllende	T8N	0
fortsætte	T9B	2
fortsættelse	T93	u
fortungevokal	T+l	5
fortvivle	T/e	m
fortvivlelse	UAE	t
fortælle	UAx	w
fortælling	UBh	/
forudse	UCg	l
forudsige	UDF	8
forvente	UEB	B8
forventning	UF9	u
forventningsværdi	UGr	BJ
forvirre	UH0	w
forår	UJv	s
forårsrulle	ULR	2
forårstegn	UKb	2
forældre	UIk	m
forødelse	UJK	l
fotograf	UMH	x
fotografere	UM4	1
fotografi	UNt	0
fra tid til anden	UWp	8
fradrage	UOh	n
frakke	UPI	o
fralandsvind	UPw	2
frankrig	UQm	m
fransk	URM	y
fransk kvinde	UTs	1
franskbrød	UR+	BE
franskmand	UTC	q
fraskilt	UUh	k
fraværelse	UVF	8
fraværende	UWB	o
fred	UXl	b
fredag	UYA	e
fredsforstyrrer	UYe	BC
fredstid	UZg	q
frelsens hær	UaK	2
fremad	UbA	p
frembringe	Ubp	BP
fremgang	Uc4	o
fremkomst	Udg	o
fremmed	UeI	v
fremmedfjendsk	Ue3	z
fremmedlegeme	Ufq	3
fremmedord	Ugh	u
fremskridt	UhP	BC
fremstillingsmetode	UiR	BS
fremtid	Ujj	k
fremtidig	UkH	n
fremtrædende	Uku	BH
fridag	Ul1	g
frigive	UmV	g
frihed	Um1	e
frikvarter	UnT	x
frimurer	UoE	x
frimærke	Uo1	4
frisk	Upt	h
frisør	UqO	0
fritænker	UrC	x
frost	Urz	v
frostboks	Usi	t
frostdag	UtP	s
frostvæske	Ut7	z
fru	Uuu	f
frue	UvN	Z
frugt	Uvm	d
frugtbar	UwD	2
fryse	Uw5	d
fryser	UxW	h
fræk	Ux3	j
frø	Uy6	m
frø	Uya	g
frøken	Uzg	h
frøæder	U0B	9
fugl	U0+	Y
fuglebestand	U1W	1
fugleedderkop	U2L	3
fugleklo	U3C	m
fugtig	U3o	j
fuld	U4L	3
fuldende	U5C	BL
fuldstændig	U6N	1
fundament	U7C	w
fungere	U7y	4
funkband	U8q	m
funkgruppe	U9Q	w
funkmusik	U+A	w
funktion	U+w	i
fylde	U/S	n
fyldepen	U/5	1
fyr	VAu	h
fyrre	VBP	a
fyrretræ	VBp	r
fyrretyve	VCU	l
fyrrum	VC5	l
fyrtårn	VDe	t
fysik	VEL	e
få	VfE	j
få	Vfn	W
får	Vf9	T
fårehund	VgQ	o
fårehyrde	Vg4	v
fårekød	Vhn	o
fædreland	VEp	v
fælde	VFY	i
fælg	VF6	n
fælles	VGh	i
fælleskøn	VHD	y
fællesmængde	VH1	0
fællessprog	VIp	BB
fængsel	VJq	q
færdig	VKU	v
færdigret	VLD	u
færdsel	VLx	h
færdselstavle	VMS	BD
fæstning	VNV	s
fætter	VOB	g
fødested	VPN	3
fødevare	VOh	s
fødsel	VQE	g
fødselsattest	VQk	8
fødselsdag	VRg	q
fødselshyppighed	VSK	/
følelse	VTJ	BD
følge	VUM	BF
følgende	VVR	w
følsom	VWB	BF
før	VXG	n
førdatid	VXt	3
føre	VYk	n
fører	VZL	1
førnutid	VaA	2
først	Va2	0
første	Vbq	g
førstehjælp	VcK	y
førsteudgave	Vc8	BB
førtidspension	Vd9	BH
gabe	ViP	Z
gade	Vio	c
gaffel	VjE	e
gage	Vji	o
gal	VkK	k
galehus	Vku	l
galleri	VlT	o
galmandsværk	Vl7	5
galop	Vm0	f
gammel	VnT	Z
gammeldansk	Vns	z
gang	Vof	4
gangster	VpX	v
garage	VqG	l
garantere	Vqr	2
garanti	Vrh	0
garderobe	VsV	q
gardin	Vs/	d
garnison	Vtc	q
gartner	VuG	k
gas	Vuq	V
gaskromatografi	Vu/	BS
gasmaske	VwR	l
gasturbine	Vw2	1
gave	Vxr	j
gavmild	VyO	i
gear	Vyw	W
ged	VzG	Z
gedde	Vzf	d
gejstlig	Vz8	i
gemme	V0e	g
gemmested	V0+	5
generation	V13	u
generel	V2l	p
genert	V3O	5
gennem	V4H	c
gennembrud	V4j	z
gennemgå	V5W	Bs
gennemse	V7C	BV
gennemsigtig	V8X	u
gennemslagskopi	V9F	8
gennemsnit	V+B	w
gennemsnitlig	V+x	1
gennemtræk	V/m	BC
gensidig	WAo	w
genstandsled	WBY	2
gentage	WCO	e
gentagelse	WCs	t
gentagne gange	WDZ	2
geografi	WEP	x
geologi	WFA	q
geometri	WFq	n
georgine	WGR	l
gerne	WG2	g
gerningsmand	WHW	2
gerningssted	WIM	4
gerrig	WJE	1
gesandt	WJ5	9
gevær	WK2	k
gift	WLa	m
giftaffald	WMA	v
gifte sig	WMv	9
gifte sig med	WNs	Bf
giftig	WPL	i
giftstof	WPt	m
giraf	WQT	i
give	WQ1	U
give efter	WRJ	BU
give et knus	WSd	1
give ud	WTS	o
glad	WT6	c
glansbillede	WUW	1
glas	WVL	Z
glasøje	WVk	m
glat	WWK	W
glemme	WWg	f
glide ud	WW/	p
glidecreme	WXo	n
glæde	WYP	j
gnide	WYy	b
gnist	WZN	Z
god	WZm	l
godaften	WaL	j
godbid	Wau	q
goddag	WbY	6
godhjertet	WcS	2
godkende	WdI	h
godmorgen	Wdp	n
godnat	WeQ	f
godnatbajer	Wev	3
godt	Wfm	c
godthåb	WgC	k
golf	Wgm	X
golfbane	Wg9	r
golfbold	Who	r
golfspiller	WiT	w
grad	WjD	h
gradbøje	Wjk	BB
gradvis	Wkl	4
grafteori	Wld	z
gram	WmQ	j
grammatik	Wmz	r
grammatikbog	Wne	3
gran	WoV	n
granat	Wo8	d
granatæble	WpZ	u
granit	WqH	g
grankogle	Wqn	u
grapefrugt	WrV	u
grapefrugtjuice	WsD	BE
gratis	WtH	x
gratismagasin	Wt4	+
gratulere	Wu2	u
grave	Wvk	m
gravhøj	WwK	o
gravsten	Wwy	BB
gren	Wxz	f
greve	WyS	h
gribe	Wyz	BZ
gribeklo	W0M	Bd
grim	W1p	k
grimasse	W2N	i
grin	W2v	d
grine	W3M	d
gris	W3p	v
grotesk	W4Y	h
grotte	W45	m
grubearbejder	W5f	x
gruble	W6Q	1
grund	W7F	t
grundantagelse	W7y	BD
grundforskning	W81	9
grundlag	W9y	5
grundled	W+r	n
grundlov	W/S	q
grundlovsdag	W/8	3
grundstemning	XAz	BB
grundstof	XB0	p
gruppe	XCd	/
gruppearbejde	XDc	2
grupperabat	XES	3
gruppesex	XFJ	t
grusom	XF2	f
grydehår	XGV	B2
grydelap	XIL	q
grå	XQl	V
græde	XI1	j
grækenland	XJY	p
græker	XKB	i
grænse	XKj	1
grænseværdi	XLY	z
græs	XML	c
græsenke	XMn	s
græshoppe	XNT	3
græsk	XOK	a
græsk kvinde	XOk	y
græsplæne	XPW	o
grævling	XP+	n
grød	XQ6	r
grøn	XRl	a
grønland	XR/	p
grønlænderstiv	XSo	BA
grønsag	XTo	k
gud	XUM	Y
gudbarn	XUk	l
guddommelig	XVJ	r
gudstjeneste	XV0	2
guirlande	XWq	w
guitar	XXa	b
gul	XX1	W
gulaglejr	XYL	x
guld	XZ4	V
guldbrakteat	XY8	8
guldfisk	XaN	n
guldkysten	Xa0	CB
guldsmed	Xc1	p
guldur	Xde	o
gulerod	XeG	l
gullasch	Xer	p
gulv	XfU	Z
gulvtæppe	Xft	m
gummi	XgT	e
gunstig	Xgx	y
guvernørpost	Xhj	/
gylden	Xii	BD
gyldig	Xjl	a
gymnasieelev	Xj/	3
gymnasium	Xk2	v
gymnastik	Xll	u
gå	Xw+	m
gå foran	Xxk	l
gå i seng	XyJ	m
gå ud	Xyv	+
gård	X1e	z
gårdsplads	Xzt	z
gårsdag	X0g	l
gås	X1F	Z
gåsepotentil	X2R	0
gåtur	X3F	j
gæld	XmT	Z
gælle	Xms	c
gærdesmutte	XnI	v
gæst	Xn3	b
gæstebog	XoS	q
gæsteforsker	Xo8	BA
gæstemad	Xp8	q
gæsteranch	Xqm	v
gæstevenskab	XrV	y
gæstfri	XsH	r
gæstmild	Xsy	p
gætte	Xtb	d
gødning	Xt4	v
gøg	Xun	d
gøre	XvE	3
gøre rent	Xv7	BD
ha det godt	YlW	/
had	X3o	W
hade	X3+	Z
hadprædikant	X4X	2
hage	X5N	Y
hagl	X5l	Z
haj	X5+	Y
hakke	X6W	a
hale	X6w	Y
hallo	X7I	X
hals	X7f	X
halsbånd	X72	u
halshugge	X8k	x
halskæde	X9V	n
halte	X98	a
halvbror	X+W	u
halvdel	X/E	a
halvfems	X/e	d
halvfjerds	X/7	m
halvfjerdsindstyve	YAh	4
halvfuld	YBZ	w
halvgud	YCJ	j
halvleder	YCs	w
halvmåne	YDc	l
halvspist	YEB	q
halvsøster	YEr	x
halvtreds	YFc	g
halvtredsindstyve	YF8	0
halvø	YGw	h
ham	YHR	S
hammer	YHj	g
hamskifte	YID	v
hamskifter	YIy	z
han	YJl	U
handel	YJ5	s
handicaptoilet	YKl	BZ
handle	YL+	5
handling	YM3	BJ
handlingslammet	YOA	4
handske	YO4	m
handskerum	YPe	y
hane	YQQ	z
hankat	YRD	d
hankøn	YRg	BC
hankønsvæsen	YSi	x
hans	YTT	S
hare	YTl	Y
harekilling	YT9	u
harmonika	YUr	q
harpiks	YVV	BB
harpun	YWW	r
hashish	YXB	e
hasselnød	YXf	m
hast	YYF	g
hastighedsgrænse	YYl	/
hat	YZk	Q
hav	YZ0	R
have	YaF	r
have medlidenhed	Yaw	BM
have medlidenhed med	Yb8	BY
have respekt	YdU	u
have respekt for	YeC	4
have ret	Ye6	d
have tillid på	YfX	8
have tillid til	YgT	BR
have uret	Yhk	n
havfrue	YiL	n
havn	Yiy	r
havre	Yjd	i
havregryn	Yj/	x
havsalt	Ykw	m
hed	YmV	T
hedde	Ymo	c
hede	YnE	j
hej	Ynn	Y
hejre	Yn/	g
heks	Yof	a
heksetro	Yo5	BF
hel	Yp+	l
held	Yqj	T
helhedsvurdering	Yq2	BS
heller ikke	Ys5	v
hellere	YsI	x
helligdag	Yto	n
helsingør	YuP	t
helst	Yu8	k
helt	Yvg	+
heltal	Ywe	t
heltinde	YxL	l
hemmelig	Yxw	f
hemmelighed	YyP	q
hemmelighedsfuld	Yy5	+
hende	Yz3	W
hendes	Y0N	Y
hensigt	Y0l	BS
hensynsled	Y13	2
hente	Y2t	p
hentydning	Y3W	v
henvendelse	Y4F	s
henvise	Y4x	n
herberg	Y5Y	s
herefter	Y6E	7
herfra	Y6/	q
herhen	Y7p	u
hermetisk	Y8X	q
hernede	Y9B	t
heroin	Y9u	m
herop	Y+U	+
herover	Y/S	v
herr	ZAB	j
herre	ZAk	l
herrebesøg	ZBJ	Bg
hertil	ZCp	l
hertugdømme	ZD4	u
herved	ZDO	q
hest	ZEm	V
hestekraft	ZE7	u
hestesko	ZFp	o
hestestald	ZGR	u
hid	ZG/	m
hidtil	ZHl	x
hilbertrum	ZIW	3
hilse	ZJN	l
hilsen	ZJy	i
himmel	ZKU	k
himmelhvælving	ZK4	z
himmellegeme	ZLr	3
himmelskrigende	ZMi	9
himmerig	ZNf	n
hinanden	ZOG	w
hindbær	ZO2	o
hindbærsnitte	ZPe	Cc
hindre	ZR6	BZ
hingst	ZTT	d
historie	ZTw	t
hjem	ZUd	X
hjemme	ZU0	a
hjemmeside	ZVO	z
hjerne	ZWB	g
hjernedød	ZWh	BF
hjerneforsker	ZXm	/
hjerte	ZYl	g
hjerte	ZZF	r
hjerteanfald	ZZw	0
hjertelig	Zbn	z
hjertestop	Zak	BD
hjortekød	Zca	y
hjul	ZdM	Z
hjælp	Zdl	b
hjælpe	ZeA	y
hjørne	Zey	k
hobby	ZfW	m
hockey	Zf8	e
hofte	Zga	c
hofteben	Zg2	p
hofteholder	Zhf	2
holde	ZiV	j
holde hus	Zjd	x
holdeplads	Zi4	l
holdning	ZkO	j
holdningstilkendegivelse	Zkx	Bh
holland	ZmS	h
hollandsk	Zmz	f
hollænder	ZnS	z
homograf	ZoF	t
honning	Zoy	i
horehus	ZpU	w
horisont	ZqE	q
horkarl	Zqu	j
horn	ZrR	s
hornhinde	Zr9	l
hornugle	Zsi	f
horoskop	ZtB	r
horrorfilm	Zts	y
hos	Zue	BI
hospital	Zvm	l
hoste	ZwL	b
hostesaft	Zwm	9
hotel	Zxj	b
hov	Zx+	W
hoved	ZyU	g
hovedbeklædning	Zy0	8
hovedpine	Zzw	n
hovedpude	Z0X	BW
hovedregning	Z1t	8
hovedrig	Z2p	p
hovedsalat	Z4D	p
hovedserie	Z3S	x
hud	Z4s	U
hudfarve	Z5V	q
hue	Z5A	V
hukommelse	Z5/	5
hul	Z64	o
hummer	Z7g	c
hummerklo	Z78	v
hun	Z8r	X
hund	Z9C	T
hundebestand	Z9V	2
hundefoder	Z+L	u
hundegalskab	Z+5	u
hundehalsbånd	Z/n	2
hundemad	aAd	m
hundesnor	aBD	t
hundestjernen	aBw	8
hundrede	aCs	x
hungersnød	aDd	v
hunkøn	aEM	2
hunkønsvæsen	aFC	1
hurtig	aF3	BA
hurtigt	aG3	w
hus	aHn	Y
husbrand	aH/	q
husdyr	aIp	t
husejer	aJW	p
huske	aJ/	z
husleje	aKy	h
husmoder	aLT	p
husnummer	aL8	+
hustru	aM6	g
hvad	aNa	d
hvad er klokken	aN3	+
hval	aO1	Y
hvede	aPN	c
hvedebrød	aPp	y
hvedemel	aQb	q
hvem	aRF	T
hvem som helst	aRY	w
hveps	aSI	X
hvepsetalje	aSf	5
hverken eller	aTY	7
hvid	aUT	X
hvidvin	aUq	p
hvile	aVT	e
hvilken	aVx	b
hvilket	aWM	c
hvirveldyr	aWo	1
hviske	aXd	d
hvislelyd	aX6	u
hvor	aYo	U
hvor fra	acn	x
hvordan	aY8	l
hvordan har de det	aZh	BL
hvorefter	aas	y
hvorfor	abe	v
hvornår	acN	a
hyggelig	adY	f
hygiejnisk	ad3	t
hyld	aek	Z
hylde	ae9	f
hyldeblomst	afc	x
hyldebær	agN	s
hylemorsom	ag5	1
hyrde	ahu	j
hyre	aiR	Z
hysterisk	aiq	m
hytte	ajQ	k
håb	bBe	T
håbe	bBx	a
hånd	bCL	a
håndjern	bCl	q
håndklæde	bDP	p
håndkuffert	bD4	4
håndled	bEw	k
håndtaske	bF/	o
håndtryk	bFU	r
håndvask	bGn	j
hår	bHK	W
hårbørste	bHg	v
hård	bIP	T
hårdhed	bIi	g
hårtørrer	bJC	y
hæk	aj0	h
hæl	akV	X
hælervare	aks	y
hæmmelyd	ale	s
hænge	amK	f
hænge op	amp	j
hængebro	anM	3
hær	aoD	a
hærværk	aod	t
hærværksmand	apK	1
hævde	ap/	l
hævn	aqk	n
hævngerrig	arL	0
hø	ar/	S
høflig	asR	BG
høflighed	atX	t
høj	auE	z
højde	au3	v
højdepunkt	avm	3
højdeskræk	awd	0
højdespring	axR	0
højdespringer	ayF	8
højforræderi	azB	BB
højhus	a0C	Bl
højre	a1n	k
højredrejning	a2L	BU
højsind	a3f	p
højskole	a4I	m
højtaler	a4u	u
højtid	a5c	2
høne	a6S	p
hønefuld	a67	s
hør	a7n	Y
høre	a7/	v
hørelse	a8u	l
høretelefon	a9T	BI
hørfrøolie	a+b	6
høst	a/V	n
høstak	a/8	l
høste	bAh	h
høvl	bBC	c
i	bJ0	t
i aften	cWk	k
i anledning af	cXI	9
i dag	cYF	W
i det mindste	cYb	q
i eftermiddag	cZF	0
i familie	cZ5	y
i forbindelse med	car	BU
i forgårs	cb/	3
i går	cc2	c
i går aftes	cdS	t
i henhold til	cd/	BK
i morgen	cfJ	h
i morgen aften	cfq	6
i morgen tidlig	cgk	9
i morges	chh	l
i nat	ciG	Y
i overmorgen	cie	8
i tide	cja	x
iagttagelse	bKh	9
ideal	bLe	c
identificere	bL6	y
identitet	bMs	q
idiot	bNW	f
idræt	bN1	c
idé	bOR	W
igen	bOn	BF
igennem	bPs	e
ihjelskyde	bQK	o
ikke	bQy	U
ikke at kunne lide	bRG	5
ilbud	bR/	d
ild	bSc	s
ilde	bTI	s
ildflue	bT0	i
ildkugle	bUW	k
ildsjæl	bU6	m
ildslukker	bVg	1
iltog	bWV	d
imidlertid	bXc	BK
imitation	bWy	q
imod	bYm	BV
importere	bZ7	p
indbetaling	bak	r
indbildning	bbP	r
indbinding	bb6	v
indbo	bcp	h
indbrud	bdK	o
indbyde	bdy	i
indbydelse	beU	t
indbygger	bfB	u
indeholde	bfv	4
indenfor	bgn	f
inder	bhG	b
inderliggørelse	bhh	BD
indeslutte	bik	m
indflydelse	bjK	y
indføre	bj8	i
indgang	bke	p
indhegning	blH	x
indhold	bl4	g
indianer	bmY	2
indien	bnO	d
individ	bnr	p
individuel	boU	0
indkomst	bpI	u
indkøb	bp2	t
indkørsel	bqj	u
indpakke	brR	v
indre	bsA	u
indretning	bsu	BH
indrette	bt1	BK
indrømme	bu/	y
indskrænke	bvx	BB
indtaste	bwy	t
indtil	bxf	h
indtryk	byA	k
industri	byk	q
industriaffald	bzO	BA
indvolde	cJo	m
infanteri	b0O	t
inflation	b07	s
influenza	b1n	2
information	b2d	9
ingen	b3a	z
ingeniør	b4N	u
ingenlunde	b47	BX
ingensteds	b6S	p
injektion	b67	u
insekt	b7p	i
insektæder	b8L	1
inspektion	b9A	t
institution	b9t	y
intelligenskvotient	b/Z	BO
intelligensniveau	cAn	BI
intelligent	b+f	6
interessant	cBv	s
interesse	cCb	o
international	cDD	4
internetforbindelse	cD7	BS
interview	cFN	o
intetsteds	cF1	o
intim	cGd	k
intolerant	cHB	v
invalid	cHw	s
invasion	cIc	m
invitere	cJC	m
irland	cKO	e
irlænder	cKs	p
ironisk	cLV	i
is	cL3	Y
isbjerg	cMP	m
isbjørn	cM1	s
ishavet	cPv	m
ishockeyspiller	cNh	BE
island	cQV	b
islandsk	cOl	h
islænding	cPG	p
issyl	cQw	g
istap	cRQ	d
iste	cRt	c
istid	cSJ	h
isvaffel	cSq	u
isvin	cTY	i
italesættelse	cT6	9
italien	cU3	d
italiener	cVU	n
iver	cV7	p
ja	ckL	S
jage	ckd	b
jaloux	ck4	b
januar	clT	i
japan	cl1	a
japaner	cmP	j
jeg	cmy	T
jeres	cnF	W
jern	cn1	X
jern	cnb	a
jernbane	coM	t
jogge	co5	Y
jord	cpR	k
jordbær	cp1	o
jordskælv	cqd	q
journalist	crH	s
jubilæum	crz	n
jul	csa	e
julesalat	cs4	j
juli	ctb	b
jungle	ct2	h
juni	cuX	b
jurist	cuy	o
jury	cva	c
juvelér	cv2	o
jyde	cwe	g
jæger	cw+	b
jævnføre	cxZ	m
kabaret	cx/	h
kabel	cyg	X
kabliau	cy3	m
kaffe	czd	d
kaffegrus	cz6	w
kaffekande	c0q	r
kaffemaskine	c1V	0
kage	c2J	Y
kahyt	c2h	c
kaj	c29	o
kakao	c3l	c
kaktus	c4B	h
kalde	c4i	i
kaldes	c5E	b
kalender	c5f	l
kalk	c6E	T
kalkulere	c6X	BA
kalkun	c7X	Z
kalv	c7w	U
kalvekød	c8E	i
kam	c8m	T
kamel	c85	Y
kamera	c9R	c
kammerat	c9t	6
kamp	c+n	y
kanal	c/Z	f
kanariefugl	c/4	r
kande	dAj	Z
kandidat	dA8	k
kanin	dBg	Z
kanon	dB5	Z
kant	dCS	9
kapitel	dDP	f
kaptajn	dDu	e
kar	dEM	V
karakter	dEh	9
karbonade	dFe	o
karburator	dGG	s
karneval	dGy	h
karosseri	dHT	2
karpe	dIJ	W
karrusel	dIf	BC
kartoffel	dJh	i
karton	dKD	g
kaserne	dKj	i
kasino	dLF	d
kasket	dLi	X
kasserolle	dL5	y
kassette	dMr	f
kastanje	dNK	w
kastanjebrun	dN6	BQ
kaste	dPK	b
kaste op	dPl	s
kaste tilbage	dQR	s
kastebold	dQ9	m
kastegynge	dRj	p
kastel	dSM	b
kasteløs	dSn	x
kastespyd	dTY	m
kastrat	dT+	e
kastrere	dUc	p
kasuar	dVF	k
kat	dVp	U
katalog	dV9	u
katapult	dWr	j
katapultsæde	dXO	0
katar	dYC	Y
katastrofal	dYa	6
katastrofe	dZU	q
katastrofefilm	dZ+	3
katastrofelanding	da1	9
katastrofeområde	dby	BC
kateder	dc0	k
katedral	ddY	s
kategori	deE	p
kategorisk	det	s
katete	dfZ	e
kateter	df3	h
katode	dgY	c
katodestråle	dg0	0
katolik	dho	h
katolisme	diJ	p
katolsk	diy	f
katost	djR	b
kaution	djs	s
kaviar	dkY	e
kede	dk2	X
kedel	dlN	f
kejser	dls	i
kejserrige	dmO	r
kemi	dm5	b
kemiker	dnU	n
kende	dn7	q
kerne	dol	d
kikkert	dpC	m
kiks	dpo	k
kilde	dqM	v
kildre	dq7	e
kilo	drZ	X
kilogram	drw	k
kilometer	dsU	w
kina	dtE	U
kind	dtY	V
kindskæg	dtt	y
kineser	duf	q
kinesisk	dvJ	j
kinin	dvs	c
kirke	dwI	BW
kirkegård	dxe	BF
kirsebær	dyj	v
kirurg	dzS	i
kiste	dz0	i
kjole	d0W	n
klage	d09	a
klar	d1X	l
klasse	d18	c
klassisk	d2Y	q
klatre	d3C	g
klima	d3i	e
klippe	d4A	/
klo	d4/	X
kloak	d5W	f
klog	d51	6
klokke	d6v	e
klokken	d7N	f
klor	d7s	g
kloster	d8M	n
klovn	d8z	b
klub	d9O	e
klæbe	d9s	Z
klæbrig	d+F	h
klæde sig	d/P	l
klæder	d+m	p
knallert	d/0	d
knap	eAR	a
knappenål	eAr	v
kneb	eBa	s
kniv	eCG	a
knogle	eCg	d
knude	eC9	h
knurre	eDe	r
knuse	eEJ	r
knytte	eE0	a
knæ	eFO	X
knægt	eFl	k
knæle	eGJ	Z
ko	eGi	U
kobber	eG2	f
koble af	eHV	k
koble fra	eH5	0
koble til	eIt	7
kobling	eJo	g
kofanger	eKI	x
koge	eK5	k
kok	eLd	Y
kokkepige	eL1	y
kokosnød	eMn	t
kold	eNU	k
kolera	eN4	d
kollega	eOV	i
kollekt	eO3	j
koloni	ePa	t
kolonne	eQH	o
kolossal	eQv	q
kombination	eRZ	x
komedie	eSK	e
komfort	eSo	h
komfortabel	eTJ	w
komisk	eT5	s
komité	eUl	l
komma	eVK	Y
kommando	eVi	h
komme	eWD	q
komme sig	eXY	m
kommentar	eWt	r
kommode	eX+	k
kompagni	eYi	j
kompas	eZF	d
komponist	eZi	p
kompromis	eaL	v
koncern	ea6	j
koncert	ebd	j
koncertsal	ecA	u
konditori	ecu	v
kondom	edd	m
konduktør	eeD	q
kone	eet	g
konge	efN	Z
kongres	efm	w
konkurrence	egW	5
konkurrenceforvridende	ehP	BY
konkurrenceforvridning	ein	Bz
konkurrere	eka	4
konservativ	elS	1
konservere	emH	BL
konstruere	enS	3
konsul	eoJ	e
konsulat	eon	n
kontakt	epO	0
kontinent	eqC	y
konto	eq0	d
kontor	erR	t
kontorist	er+	l
kontrollere	esj	BP
konversation	ety	4
konvolut	euq	n
kop	evR	T
kopi	evk	X
kopiere	ev7	h
kopper	ewc	f
kor	ew7	e
korridor	exZ	y
korrigere	eyL	k
kors	eyv	W
korsvej	ezF	k
kort	ezp	i
kost	e0L	W
koste	e0h	Z
krabbe	e06	a
kradse	e1U	d
kraft	e1x	r
krage	e2c	Z
krebs	e21	b
kredit	e3Q	e
kridt	e3u	Y
krig	e4G	U
krigs	e4a	c
kristen	e42	i
kristendom	e5Y	w
kritik	e6I	l
kritisere	e6t	4
kritisk	e7l	o
kro	e8N	b
krokodille	e8o	t
krom	e9V	a
krone	e9v	c
krop	e+L	d
krucifiks	e+o	u
krybe	e/W	f
krystal	e/1	f
kræve	fAU	BA
kuffert	fBU	c
kugle	fBw	X
kul	fCH	S
kulde	fCZ	X
kultur	fCw	h
kulør	fDR	j
kumme	fD0	l
kun	fEZ	l
kunde	fE+	i
kundskab	fFg	u
kunne	fGO	h
kunne lide	fGv	v
kunst	fHe	V
kunstig	fHz	j
kupon	fIW	d
kupé	fIz	n
kursus	fJa	n
kurv	fKB	b
kusine	fKc	c
kvadrat	fK4	g
kvadratmeter	fLY	1
kvars	fMN	e
kvarter	fMr	BU
kviksølv	fN/	x
kvinde	fOw	b
kvindelig	fPL	t
kvindelig sekretær	fP4	BF
kvit	fQ9	p
kvittering	fRm	BB
kvæg	fSn	b
kvæle	fTC	k
kylling	fTm	j
kynisk	fUJ	c
kys	fUl	W
kysse	fU7	Y
kyst	fVT	l
kål	fad	W
kålorm	faz	j
kårde	fbW	b
kæbe	fV4	e
kæde	fWW	Y
kælder	fWu	m
kæmme	fXU	X
kæmpe	fXr	j
kær	fYO	r
kærlighed	fY5	z
kærne	fZs	x
københavn	fbx	r
køber	fcc	t
købesum	fdJ	r
købmand	fd0	1
kød	fep	m
køkken	ffP	i
køkkenbord	ffx	u
køkkenskab	fgf	z
køl	fhS	Z
køler	fhr	h
køleskab	fiM	q
kølig	fi2	Y
køn	fjO	h
køre	fjv	v
kørekort	fke	y
køretilladelse	flQ	8
køretøj	fmM	q
laboratorium	fm2	3
lade	fnt	3
lade fordampe	fok	z
lade sig skille	fpX	BA
lade som om	fqX	1
lade vandet	frM	q
lagen	fr2	c
lager	fsS	BI
laks	fta	b
lam	ft1	X
lampe	fuM	c
land	fuo	x
lande	fvZ	V
landgang	fvu	g
landkort	fwO	b
landmand	fwp	b
landsby	fxE	d
landskab	fxh	o
landsmand	fyJ	h
lang	fyq	V
langsom	fy/	e
langsomt	fzd	t
langt	f0K	c
languster	f0m	l
lap	f1L	Z
larm	f1k	e
last	f2C	j
lastbil	f2l	j
lastrum	f3I	b
lastvogn	f3j	n
latinsk	f4K	c
latter	f4m	c
latterlig	f5C	n
lav	f5p	s
lava	f6V	U
lave	f6p	0
lavine	f7d	e
le	f77	f
lede	f8a	r
leder	f9F	p
ledsage	f9u	i
leg	f+Q	S
legal	f+i	Z
legation	f+7	m
lege	f/h	V
legeme	f/2	e
legering	gAU	o
leje	gA8	p
lejekontrakt	gBl	z
lejer	gCY	n
lejlighed	gC/	Bc
lektion	gEb	j
ler	gE+	W
let	gFU	u
lettelse	gGC	f
lettet	gGh	d
leve	gG+	e
levende	gHc	c
lever	gH4	Z
leverance	gIR	q
levering	gI7	p
liberal	gJk	i
lidt	gKG	/
lift	gLF	f
lig	gLk	g
lige	gME	q
lige så som	gNU	v
ligevægt	gMu	m
ligge	gOD	BV
lighed	gPY	u
ligne	gQG	k
lignende	gQq	w
likør	gRa	h
lilje	gR7	Y
lille	gST	y
limonade	gTF	o
lind	gTt	m
lineal	gUT	n
linie	gU6	Y
linse	gVS	a
liste	gVs	Y
liter	gWE	f
litteratur	gWj	y
liv	gXV	T
livlig	gXo	3
loft	gYf	l
loftsrum	gZE	h
logisk	gZl	e
lokomotiv	gaD	n
lomme	gaq	a
lommetørklæde	gbE	9
london	gcB	f
loppe	gcg	Y
lort	gc4	e
lotteri	gdW	u
lov	geE	R
love	geV	Y
luft	get	T
lufthavn	gfA	k
lugt	gfk	q
lugte	ggO	y
lugte af	ghA	j
lukke	ghj	d
lukket	giA	h
luksus	gih	c
lunge	gi9	X
lunken	gjU	d
lus	gjx	U
lyd	gkF	V
lyde	gka	W
lydig	gkw	Z
lykke	glJ	d
lykkelig	glm	r
lykkeligvis	gmR	z
lykkes	gnE	d
lykønske	gnh	r
lyn	goM	Y
lys	gok	w
lytte	gpU	Z
lytte til	gpt	l
lyve	gqS	e
låg	g3X	f
lån	g32	T
låne	g4J	0
lår	g49	T
lås	g5Q	T
låse	g5j	W
læbe	gqw	V
læder	grF	d
læg	gri	q
læge	gsM	n
lægemiddel	gsz	BD
lægge	gt2	6
lægge mærke til	guw	6
lægge sig	gvq	m
lægge vægt på	gwQ	BJ
lækkert	gxZ	h
læne sig	gyi	h
lænestol	gx6	o
længde	gzD	c
længes efter	gzf	u
længsel	g0N	6
lære	g1H	Y
lærer	g1f	p
lærk	g2I	Z
læse	g2h	W
læsebog	g23	g
løbe	g55	V
løbe på skøjter	g6O	3
løbe sammen	g7F	s
løfte	g7x	BD
løg	g80	W
løgn	g9K	W
løjtnant	g9g	l
løn	g+F	k
lørdag	g+p	l
løs	g/O	W
løslade	g/k	1
løve	hAZ	X
mad	hAw	S
madras	hBC	e
mager	hBg	BI
magnet	hCo	c
maj	hDE	W
majs	hDa	y
makeup	hEM	v
makrel	hE7	f
malaria	hFa	i
male	hF8	s
maler	hGo	e
malke	hHG	a
malmø	hHg	r
manchet	hIL	g
mand	hIr	r
mandag	hJW	c
mandarin	hJy	m
mandlig	hKY	p
mandskab	hLB	e
maner	hLf	n
mange	hMG	Y
mange tak	hNY	w
mangel	hMe	6
marchere	hOI	o
mareridt	hOw	p
margarine	hPZ	s
mark	hQF	h
marmelade	hQm	v
marmor	hRV	i
marts	hR3	a
martyr	hSR	i
maske	hSz	a
maskere	hTN	b
maskine	hTo	r
maskinskrive	hUT	p
maskinskriverske	hU8	9
massage	hV5	h
masse	hWa	b
massere	hW1	d
mast	hXS	T
matematik	hXl	s
materiale	hYR	z
materie	hZE	v
materiel	hZz	n
mave	haa	c
mavesmerte	ha2	BR
med	hcH	T
meddele	hca	BW
meddelelse	hdw	5
medekrog	hep	i
medesnøre	hfL	m
medestang	hfx	p
medicin	hga	8
medicinsk	hhW	p
medikament	hh/	BB
medlem	hjA	7
medlidenhed	hj7	2
meget	hkx	q
mejeri	hlb	i
mejsel	hl9	c
mekanik	hmZ	k
mekaniker	hm9	l
mel	hni	e
mellem	hoA	i
melodi	hoi	l
melon	hpH	a
men	hph	R
mene	hpy	r
mening	hqd	e
menneske	hq7	o
menneskehed	hrj	3
menneskelig	hsa	n
menu	htB	X
mer og mer	huF	8
mere	htY	t
messing	hvB	d
metal	hve	Y
meter	hv2	a
metode	hwQ	d
middag	hwt	5
midnat	hxm	e
midte	hyE	o
mikrofon	hys	u
mikroskop	hza	w
mil	h0K	X
mild	h0h	c
militær	h09	6
milliard	h13	o
millimeter	h2f	w
million	h3P	n
miltbrand	h32	q
min	h4g	P
mindre	h4v	k
mindre og mindre	h6B	BC
mindreårig	h5T	u
mine	h7D	S
mineral	h7V	k
minimal	h75	i
minister	h8b	p
ministerium	h9E	3
minut	h97	f
misforstå	h+a	u
mission	h/I	f
mistanke	h/n	j
mistro	iAK	5
misunde	iBD	c
misundelig	iBf	w
misundelse	iCP	j
mit	iCy	P
mod	iDB	X
mode	iDY	e
model	iD2	X
moden	iEN	f
moder	iEs	a
moderne	iFG	i
modernisere	iFo	y
modig	iGa	v
modsat	iHJ	9
modstand	iIG	j
modstandskraft	iIp	1
modsætning	iJe	BX
modtage	iK1	BG
modtagelig	iL7	5
modtager	iM0	BA
modvilje	iN0	v
moms	iOj	n
montage	iPK	BX
montør	iQh	t
monument	iRO	k
mor	iRy	Y
moral	iSK	a
morbror	iSk	2
mord	iTa	Z
morder	iTz	i
morfin	iUV	s
morgen	iVB	g
morgenmad	iVh	r
morsom	iWM	y
mosaik	iW+	t
moske	iXr	f
moster	iYK	v
motel	iY5	X
motor	iZQ	g
motorbåd	iZw	n
motorcykel	iaX	s
motorhjelm	ibD	r
mug	ibu	U
muhamedaner	icC	BM
muldvarp	idO	d
mulig	idr	a
mulighed	ieF	o
muligvis	iet	BI
multiplicere	if1	BB
mund	ig2	U
munk	ihK	U
munter	ihe	q
mur	iiI	W
mursten	iie	h
mus	ii/	U
museum	ijT	b
musical	iju	g
musik	ikO	a
musiker	iko	l
musikinstrument	ilN	BH
muskel	imU	g
muskelbiopsi	im0	4
myg	ins	U
myndig	ioA	2
myndighed	io2	0
mynte	ipq	X
myre	iqB	b
mytologi	iqc	p
mytteri	irF	3
måge	ivS	Z
mål	ivr	BE
måle	iwv	b
måltid	ixK	e
måne	ixo	W
måned	ix+	a
måske	iyY	BA
måtte	izY	y
mælk	ir8	V
mængde	isR	BG
mærke	itX	b
mærkelig	iue	0
mærkevare	ity	s
møbler	i0K	i
møbleret	i0s	m
møde	i1S	z
mødes	i2F	y
møl	i23	V
mønster	i3M	r
mørk	i33	7
mørke	i4y	n
møtrik	i5Z	d
nabo	i52	b
nabolag	i6R	x
naiv	i7C	e
nakke	i7g	p
nat	i8J	S
nation	i8b	b
national	i82	j
nationalitet	i9Z	y
natur	i+L	c
naturlig	i+n	k
naturligvis	i/L	x
navn	i/8	i
ned	jAe	l
ned ad	jFA	u
nede	jBD	u
nederdel	jBx	j
nederlag	jCU	i
nederlandene	jC2	9
nederlandsk	jDz	m
nedtrykt	jEZ	n
negerbolle	jFu	Cm
negl	jIU	V
negligé	jIp	x
nej	jJa	V
nem	jJv	g
nemlig	jKP	h
neon	jKw	Y
nerve	jLI	c
nervøs	jLk	t
net	jMR	b
neutral	jMs	v
nevø	jNb	c
ni	jN3	R
niece	jOI	c
niende	jOk	b
nitten	jO/	d
nittende	jPc	j
niveau	jP/	Z
nogensinde	jQY	4
nogensteds	jRQ	w
noget	jSA	l
nok	jSl	BR
nonne	jT2	X
nord	jUN	f
nord for	jUs	i
nordamerika	jVO	1
nordisk	jWD	p
nordlig	jWs	i
nordmand	jXO	n
nordpolen	jX1	0
nordrhodesia	jYp	B7
nordsøen	jak	s
norge	jbQ	e
normal	jbu	Z
norsk	jcH	c
notar	jcj	b
notesbog	jc+	l
novelle	jdj	o
november	jeL	p
nu	je0	c
nu for tiden	jhv	BH
nu til dags	ji2	BB
nul	jfQ	0
nulke	jgE	Z
nummer	jgd	k
nummerplade	jhB	u
ny	jj3	V
nyde	jkM	h
nyhed	jkt	v
nylig	jlc	a
nylon	jl2	Z
nyse	jmP	W
nysgerrig	jml	/
nyttig	jnk	s
nå	jyN	g
nåde	jyt	l
nål	jzS	V
næb	joQ	d
nægte	jot	u
næppe	jpb	1
nær	jqQ	q
nære	jq6	g
nærhed	jra	u
nærheden	jsI	z
næring	js7	p
nærværende	jtk	BM
næse	juw	W
næst	jvG	e
næste	jvk	h
næste	jwF	t
næste	jwy	c
næsten	jxO	k
næve	jxy	b
nødbremse	jzn	BJ
nødt	j0w	d
nødvendig	j1N	o
nødvendighed	j11	z
nøgen	j2o	n
nøgenhed	j3P	w
nøgle	j3/	h
oase	j4g	X
obducere	j43	z
obduktion	j5q	2
obelisk	j6g	f
oberst	j6/	c
oberstløjtnant	j7b	9
objekt	j8Y	i
objektiv	j86	o
objektivitet	j9i	4
objektsprædikat	j+a	BH
oblat	j/h	Y
obligation	j/5	m
obligationsejer	kAf	8
obligationskurs	kBb	/
obligationsmarked	kCa	BB
obligatorisk	kDb	0
obo	kEP	Z
observation	kEo	4
observatorium	kFg	+
observatør	kGe	4
observere	kHW	y
obskur	kII	i
obskøn	kIq	h
obsternasig	kJL	t
obstetrik	kJ4	t
obstruktion	kKl	w
obstruktionspolitik	kLV	BJ
occidenten	kMe	u
ocean	kNM	a
oceandamper	kNm	s
oceanograf	kOS	z
od	kPF	U
odalisk	kPZ	g
odde	kP5	X
odder	kQQ	b
odeur	kQr	d
odiøs	kRI	g
odysseen	kRo	k
offensiv	kSM	x
offentlig	kS9	j
offentliggøre	kTg	BO
offer	kVl	e
offerbål	kWD	y
offerkniv	kW1	1
offerlam	kXq	y
offerrolle	kYc	0
offfentlighed	kUu	3
officer	kZQ	j
officiel	kZz	p
officin	kac	r
offside	kcI	g
ofre	kbH	f
ofring	kbm	i
ofte	kco	v
oftest	kdX	h
og	kd4	X
også	keP	m
ohøj	ke1	Z
okker	kfO	a
okkerfarvet	kfo	u
okkult	kgW	d
okkultisme	kgz	t
okkupation	khg	t
okkupationsmagten	kiN	BI
okkupere	kjV	l
okkupering	kj6	w
okse	kkq	Z
oksekød	klD	m
oksemørbrad	klp	BH
oktant	kmw	c
oktantal	knM	n
oktav	knz	a
oktavformat	koN	r
oktet	ko4	b
oktober	kpT	k
oktrojeret	kp3	y
okulerkniv	kqp	4
olddansk	krh	j
oldebarn	ksE	q
oldeforældre	ksu	+
olden	kts	Y
oldenborgerne	kuE	/
oldenborre	kvD	w
oldengelsk	kvz	q
oldermand	kwd	v
oldfransk	kxM	o
olding	kx0	f
oldnordisk	kyT	w
oldsager	kzD	m
oldskrift	kzp	r
olie	k0U	X
oliven	k0r	g
olivenolie	k1L	t
oliventræ	k14	u
olympisk	k2m	m
om	k3M	Bq
om aftenen	lDg	u
om forladelse	lEO	x
omegn	k42	x
omelet	k5n	f
omfang	k6G	BA
omfavne	k7G	s
omgive	k7y	f
omgivelse	k8R	BD
omgås	k9U	k
omklædningsrum	k94	BA
omkring	k+4	6
omnibus	k/y	l
område	lAX	x
omsorg	lBI	g
omsætning	lBo	q
omtale	lCS	e
omtrent	lCw	w
ond	lE/	p
onkel	lFo	Z
onsdag	lGB	h
op	lGi	o
op ad	lo9	x
opblæse	lHK	i
opdage	lHs	o
opdagelse	lIU	n
opdrage	lI7	6
opdragelse	lJ1	w
opera	lKl	d
operahus	lLC	t
operation	lLv	BB
operere	lMw	l
opfattelse	lNV	BA
opfinde	lOV	g
opfindelse	lO1	q
opføre sig	lPf	9
opførsel	lQc	BK
opgave	lRm	v
opgivelse	lSV	BE
ophavsmand	lTZ	w
ophold	lUJ	c
opholde	lUl	z
ophøre	lVY	n
opium	lV/	Z
oplag	lWY	b
oplevelse	lWz	p
oplyse	lXc	o
oplysning	lYE	q
oplysningskontor	lYu	BH
opløse	lZ1	j
opmuntre	laY	q
opmærkningssprog	lbC	BG
opmærksom	lcI	t
opmærksomhed	lc1	BY
opposition	leN	r
oppumpe	le4	d
opretholde	lfV	w
oprette	lgF	2
oprindelig	lg7	2
oprindelse	lhx	o
oprøre	liZ	7
opsigt	ljU	i
opslag	lj2	t
opslagsværk	lkj	6
opstand	lld	0
optage	lmR	r
optiker	lm8	m
optimist	lni	m
opvaskemaskine	loI	1
oralsex	lpu	n
orange	lqV	q
ord	lq/	V
ordbog	lrU	y
ordbogsartikel	lsG	BB
ordenstal	ltH	s
ordfører	ltz	w
ordinær	luj	5
ordkløver	lvc	0
ordne	lwQ	i
ordning	lwy	e
ordre	lxQ	c
ordret	lxs	j
ordspil	lyP	i
ordsprog	lyx	q
organ	lzb	X
organdonor	lzy	v
organisation	l0h	0
organisere	l1V	s
orgel	l2B	X
orientalsk	l2Y	x
orkester	l3J	l
orkestergrav	l3u	3
orkidé	l4l	n
orm	l5M	U
orne	l5g	a
ortografi	l56	v
os	l6p	O
ost	l63	V
otte	l7M	W
ottende	l7i	e
oven	l8A	x
over	l8x	Bn
overall	l+Y	j
overalt	l+7	u
overarbejde	l/p	x
overarm	mAa	0
overbevise	mB3	2
overbevisning	mCt	BB
overbid	mBO	p
overblik	mDu	BF
overdrive	mEz	r
overflade	mFe	0
overgå	mGS	q
overkrop	mG8	r
overmand	mHn	n
overmængde	mIO	v
overordnet	mI9	z
overraske	mJw	q
overraskelse	mKa	x
overskæg	mLL	s
overspringshandling	mL3	BL
oversygeplejerske	mNC	BA
oversætte	mOC	t
oversættelse	mOv	2
overtale	mPl	p
overtro	mQO	t
overtroisk	mQ7	y
overtyde	mRt	w
overvågningsliste	mTL	BF
overvælde	mSd	u
ovn	mUQ	s
pakke	mU8	9
pakke ud	mV5	k
palads	mWd	a
palme	mW3	g
pande	mXX	Z
panik	mXw	Y
panorama	mYI	h
papegøje	mYp	q
papir	mZT	f
papirhandel	mZy	1
papirkurv	man	0
paprika	mbb	n
parade	mcC	t
paradis	mcv	n
paragraf	mdW	u
parallel	meE	l
paraply	mep	p
parfume	mfS	d
paris	mfv	a
park	mgJ	V
parkere	mge	b
parlament	mg5	m
parre sig	mhf	k
parti	miD	n
partifælle	miq	w
paryk	mja	k
pas	mj+	V
passager	mkT	l
passe	mk4	Bp
passende	mmh	m
patent	mnH	a
pater	mnh	Z
patient	mn6	d
patriotisk	moX	u
patron	mpF	f
pattegris	mpk	j
pause	mqH	1
pave	mq8	V
pavillon	mrR	m
peber	mr3	b
peberrod	msS	8
pedal	mtO	Z
pejs	mtn	X
pels	mt+	n
penge	mul	Y
pengeafpresning	mu9	BC
pengeseddel	mv/	t
perfekt	mws	i
periode	mxO	n
perle	mx1	f
perron	myU	BL
persianer	mzf	q
persille	m0J	o
person	m0x	j
personlig	m1U	o
personnummer	m18	4
pervers	m20	k
pest	m3Y	m
petroleum	m3+	4
pfennig	m42	d
pibe	m5T	Y
picnic	m5r	d
pige	m6I	k
pil	m6s	V
pilgrim	m7B	p
pille	m7q	b
pinse	m8F	p
pioner	m8u	g
piskeris	m9O	o
pistol	m92	r
pjalt	m+h	b
plads	m+8	Bd
plage	nAZ	i
plan	nA7	r
planere	nBm	b
planet	nCB	b
planlægge	nCc	BA
plante	nDc	d
pleje	nD5	p
plet	nEi	a
pligt	nE8	k
plov	nFg	W
pludselig	nF2	q
pludseligt	nGg	0
plukke	nHU	o
plyndre	nH8	o
pløje	nIk	a
podium	nI+	l
polak	nJj	Z
polen	nJ8	c
politibetjent	nKY	5
politik	nLR	t
politisk	nL+	4
politistation	nM2	7
pony	nNx	U
poppel	nOF	c
populær	nOh	n
port	nPI	o
portier	nPw	g
portion	nQQ	g
porto	nQw	e
portræt	nRO	g
portugal	nRu	o
portugiser	nSW	y
post	nTI	c
postbud	nTk	i
posthus	nUG	k
postnummer	nUq	1
postvæsen	nVf	q
potte	nWJ	v
potteplante	nW4	x
pragtfuld	nXp	q
praktisere	nYT	z
praktisk	nZG	l
prale	nZr	f
presse	naK	a
primitive	nak	BI
princip	nbs	j
principiel	ncP	BQ
prins	ndf	a
prinsesse	nd5	l
pris	nee	X
privat	ne1	e
problem	nfT	q
proces	nf9	y
procession	ngv	q
producere	nhZ	0
produkt	niN	g
produktion	nit	t
professor	nja	k
profil	nj+	b
profitere	nkZ	o
programmør	nlB	3
projekt	nl4	u
prop	nmm	Z
propaganda	nm/	4
proptrækker	nn3	y
prospektkort	nop	4
prostitueret	nph	z
protest	nqU	e
protestere	nqy	m
protokol	nrY	y
provokere	nsK	6
prædikant	ntE	m
prædike	ntq	f
præmie	nuJ	l
præservativ	nuu	1
præsident	nvj	y
præst	nwV	+
prøve	nxT	o
psykiater	nx7	s
psykisk	nyn	g
pude	nzH	l
pudse sin næse	nzs	5
pukkel	n0l	e
pullover	n1D	t
pumpe	n1w	X
pund	n2H	V
pung	n2c	d
punkt	n25	q
pyjamas	n3j	e
pyramide	n4B	n
på	n5K	Bn
på gensyn	oAJ	0
påfaldende	n6x	p
pågældende	n7a	5
pålidelig	n8T	1
pårørende	n9I	t
påske	n91	c
påskud	n+R	j
påstand	n+0	v
påstå	n/j	m
pære	n4o	i
pølse	oA9	d
rabbiner	oBa	g
race	oB6	d
radikal	oCX	k
radio	oC7	k
radise	oDf	g
ragout	oD/	f
raket	oEe	b
rand	oE5	BK
ransage	oGD	f
rar	oGi	BJ
rasende	oHr	f
rask	oIK	f
rat	oIp	s
rav	oJV	Z
reagere	oJu	u
reb	oKc	l
recitere	oLB	p
redaktør	oLq	u
redde	oMY	m
rede	oM+	8
redningsbåd	oO6	v
redningsbælte	oN6	BA
redskab	oPp	q
reel	oQT	s
reflektere	oQ/	r
regel	oRq	i
regelmæssig	oSM	v
regere	oS7	5
regering	oT0	7
regiment	oUv	n
region	oVW	i
regional	oV4	q
registrere	oWi	2
regn	oXY	W
regnbue	oXu	g
regne	oYO	Z
regning	oYn	0
rejse	oZb	3
rejse bort	ob6	BW
rejse sig	odQ	t
rejsebureau	oaS	BE
rejsende	obW	k
reklame	od9	x
rekord	oeu	d
rekreation	ofL	5
rekrut	ogE	f
religion	ogj	o
religiøs	ohL	r
ren	oh2	T
rendezvous	oiJ	8
renhed	ojF	s
renovere	ojx	n
rense	okY	0
reparere	olM	BL
reproduktion	omX	3
republik	onO	n
reservere	on1	n
respekt	ooc	g
respektere	oo8	s
rest	opo	g
restaurant	oqI	r
resultat	oqz	3
ret	orq	T
retfærdig	or9	0
retfærdighed	osx	BA
retning	otx	i
rette	ouT	a
rettidigt	out	2
reumatisme	ovj	u
revidere	owR	n
revolution	ow4	w
revolver	oxo	o
ribs	oyQ	q
ride	oy6	W
ridse	ozQ	l
rig	oz1	w
rigdom	o0l	0
rigtig	o1Z	3
ringe	o2Q	u
ris	o2+	U
risikabel	o3S	+
risikere	o44	z
risiko	o4Q	o
rival	o5r	a
rive itu	o6F	k
ro	o6p	k
rod	o7N	BA
roe	o8N	X
rolig	o8k	t
rolle	o9R	o
roman	o95	Z
romantisk	o+S	n
romersk	o+5	d
ror	o/W	r
rose	pAB	6
rosenkål	pA7	q
rotte	pBl	a
ru	pB/	b
rubin	pCa	Y
rug	pCy	S
ruin	pDE	Y
ruinere	pDc	g
rulle	pD8	c
rullegardin	pEY	1
rum	pFN	e
rummelig	pFr	5
rund	pGk	V
rundstykke	pG5	j
rusland	pHc	d
russer	pH5	e
russisk	pIX	g
rusten	pI3	b
rutine	pJS	e
rydde op	pJw	5
ryg	pKp	Y
ryge	pLB	V
rygere	pLW	f
rygrad	pL1	l
rygte	pMa	1
rykke	pNP	Z
ryste	pNo	BJ
rytme	pOx	b
rå	pTW	b
råb	pTx	a
råbe	pUL	f
råd	pUq	g
råde	pVK	j
rådhus	pVt	0
rådne	pWh	k
rædsel	pPM	5
rædsom	pQF	CG
rækkehus	pSL	4
ræv	pTD	T
rød	pXF	W
rødgran	pXb	i
rødspætte	pX9	n
røg	pYk	X
røn	pY7	l
rør	pZg	w
røre sig	paQ	j
røv	paz	a
røver	pbN	f
sadel	pbs	Z
saft	pcF	b
saks	pcg	Z
sal	pc5	h
salami	pda	Z
salat	pdz	k
salg	peX	T
salt	peq	T
saltvand	pe9	g
samle	pfd	r
samlever	pgI	7
samling	phD	j
sammen	phm	d
sammenligne	piD	o
sammenligning	pir	y
samtykke	pjd	Bv
sand	plM	d
sandal	plp	Z
sandet	pmC	Z
sandhed	pmb	q
sandsynlig	pnF	r
sandsynligvis	pnw	u
sandwich	poe	h
sang	po/	V
sangbog	ppU	g
sanger	pp0	d
sans	pqR	U
satellit	pql	k
sauce	prJ	g
sauna	prp	X
sav	psA	Q
save	psQ	U
savne	psk	i
scene	ptG	W
schilling	ptc	j
schäferhund	puq	r
schæferhund	pt/	r
se	pvV	U
se efter	qAu	v
se ud	qBd	k
sejl	pvp	V
sejle	pv+	Y
sejr	pwW	b
sekretær	pwx	r
seks	pxc	U
seksten	pxw	e
sekstende	pyO	k
seksuel	pyy	t
sekund	pzf	g
seler	pz/	l
selskab	p0k	5
selv	p1d	4
selvstarter	p2V	o
selvstændig	p29	t
selvtillid	p3q	/
sen	p4p	a
sende	p5D	g
sende afbud	p5j	Bm
seng	p7J	T
sennep	p7c	c
sensation	p74	o
sent	p8g	V
september	p81	r
serie	p9g	m
serum	p+G	e
servere	p+k	j
service	p/H	r
serviet	p/y	p
sex	qAb	T
shorts	qCB	l
sidde	qCm	b
side	qDB	k
siden	qDl	w
sidst	qEV	W
sidste	qEr	j
sidste nat	qFO	o
sifon	qF2	b
sige	qGR	Y
sige goddag	qGp	t
sige ja tak til	qHW	BN
sige nej tak til	qIj	5
signal	qJc	r
signalhorn	qKH	z
sigte	qK6	g
sigøjner	qLa	s
sikker	qMG	j
sikkerhed	qMp	x
sikkerhedsnål	qNa	1
sikre	qOP	p
sild	qO4	X
silke	qPP	Y
sin	qPn	h
sindssyg	qQI	w
sirup	qQ4	a
sit	qRS	h
sjette	qRz	a
sjov	qSN	m
sjælden	qSz	o
sjælland	qTb	e
skab	qT5	z
skabelon	qUs	f
skade	qVL	m
skadelig	qVx	q
skak	qWb	W
skam	qWx	W
skamme sig	qXq	p
skammelig	qXH	j
skandinavien	qYT	w
skarp	qZD	W
skarphed	qZZ	/
skat	qaY	h
ske	qa5	/
ske	qb4	Y
skelet	qcQ	i
skelne	qcy	m
skema	qdY	n
skeptisk	qd/	k
ski	qej	W
skib	qe5	h
skilles	qfa	y
skilling	qgM	m
skilsmisse	qgy	q
skind	qhc	l
skinke	qiB	d
skinne	qie	a
skinsyge	qi4	l
skive	qjd	l
skjorte	qkC	k
skjule	qlW	l
skjule sig	qkm	w
sko	ql7	X
skobånd	qmS	n
skole	qm5	c
skomager	qnV	m
skorsten	qn7	BK
skotland	qpF	l
skotte	qpq	o
skov	qqS	h
skovl	qqz	c
skrabe	qrP	q
skrald	qr5	t
skraldespand	qsm	w
skridt	qtW	o
skrifte	qt+	h
skriftemål	quf	w
skrige	qvP	u
skrive	qv9	g
skrivebord	qwd	5
skrivemaskine	qxW	2
skrue	qyM	w
skruenøgle	qy8	BB
skruetrækker	qz9	3
skrædder	q00	n
skrækkelig	q1b	BP
skrælle	q2q	o
skrænt	q3S	1
skubbe	q4H	p
skudår	q4w	m
skuespiller	q5W	u
skuffe	q6E	+
skuffelse	q7C	t
skulder	q7v	k
skulle	q8T	0
skulptur	q9H	p
skum	q9w	f
skumme	q+P	f
skumring	q+u	u
skur	q/c	i
sky	q/+	BK
skyde	rBI	e
skygge	rBm	o
skyld	rCO	p
skylde	rC3	c
skyldig	rDT	c
skylle	rDv	j
skynde sig	rES	1
skål	rKC	k
skåne	rKm	a
skæg	rFH	X
skæl	rFe	W
skælde	rF0	q
skældsord	rGe	0
skænderi	rHS	w
skændes	rIC	n
skændsel	rIp	e
skære	rJH	f
skærm	rJm	c
skøge	rLA	h
skøn	rLh	0
skønhed	rMV	i
skør	rM3	x
sladre	rNo	f
slag	rOH	7
slags	rPC	b
slagsmål	rPd	8
slagter	rQZ	h
slange	rQ6	k
slank	rRe	g
slet	rR+	r
slet ikke	rTC	o
slette	rSp	Z
slips	rTq	f
slot	rUJ	Y
sludre	rUh	0
slukke	rVV	m
slutte	rV7	BB
slå	rYK	v
slås	rY5	g
slægt	rW8	o
slægtning	rXk	m
sløv	rZZ	r
smag	raE	U
smage	raY	X
smal	rav	V
smaragd	rbE	f
smed	rbj	X
smelte	rb6	Z
smerte	rcT	i
smertelig	rc1	m
smigre	rdb	g
smil	rd7	W
smile	reR	X
sminke	reo	s
smitte	rfU	b
smuk	rfv	3
småpenge	rgm	j
smør	rhJ	g
smøre	rhp	q
smørrebrød	riT	+
snabela	rjR	BB
snakke	rkS	BC
snaksom	rlU	j
snart	rl3	V
snavse til	rnK	m
snavset	rmM	+
sne	rnw	X
snegl	roH	b
snor	roi	q
snorke	rpM	b
social	rpn	Z
sofa	rqA	1
sok	rq1	Y
sol	rrN	W
solbær	rrj	q
solbærsaft	rsN	8
soldat	rtJ	m
solnedgang	rtv	v
solopgang	rue	u
solsikke	rvM	o
solsikkeolie	rv0	3
solsort	rwr	n
som	rxS	Z
som regel	ry7	3
sommer	rxr	h
sommerfugl	ryM	v
sorg	rzy	e
sort	r0Q	X
souvenir	r0n	9
sove	r1k	g
sovekammer	r2E	p
sovesofa	r2t	h
sovevogn	r4g	r
soveværelse	r3O	s
sovjetisk	r36	m
spade	r5L	Y
spadseretur	r5j	z
spalte	r6W	u
spand	r7E	c
spanien	r7g	b
spanier	r77	d
spare	r8Y	d
spark	r81	X
sparke	r9M	Y
speciel	r9k	v
spedalskhed	r+T	q
spejl	r+9	o
spejlæg	r/l	k
spids	sAJ	BA
spil	sBJ	V
spilde	sBe	a
spille	sB4	Z
spinat	sCR	c
spindelvæv	sCt	p
spion	sDW	Y
spiral	sDu	e
spisekammer	sEM	p
spiselig	sE1	f
spisesal	sFU	l
spiseseddel	sF5	k
spisestue	sGd	m
sport	sHD	Y
sprede	sHb	1
spring	sIQ	g
springe	sIw	r
sprit	sJb	l
sprog	sKA	i
spurv	sKi	e
spytte	sLA	a
spædbarn	sLa	e
spændende	sL4	j
spænding	sMb	h
spærring	sM8	j
spøge	sNf	e
spørge	sN9	b
spørgsmål	sOY	n
stadig	sO/	+
stadion	sP9	k
stald	sQh	i
stamme	sRD	k
stamme	sRn	e
standse	sSF	z
star	sS4	i
stat	sTa	U
station	sTu	0
stationsforstander	sUi	BD
statsborger	sVl	s
status	sWR	l
stave	sW2	Y
sted	sXO	Bx
stege	sY/	g
stegepande	sZf	t
stejl	saM	g
stemme	sas	k
stemme overens	sbQ	BZ
stemning	scp	i
sten	sdL	j
sten	sdu	W
stenografi	seE	8
sti	sfA	T
stifte bekendtskab med	sfT	BR
stige	sgk	X
stige ud	sg7	BH
stik	siC	t
stikke	siv	m
stikkelsbær	sjV	u
stikkontakt	skD	0
stilk	sk3	e
stille	slV	x
stilling	smG	BI
stimulere	snO	5
stinke	soH	y
stiv	so5	d
stjerne	spW	e
stjæle	sp0	b
stof	sqP	v
stol	sq+	Y
stole på	srW	r
stolt	ssB	Z
stoppe	ssa	g
stor	ss6	l
storbritannien	stf	BM
stork	sur	Y
storm	svD	W
straf	svZ	e
straffe	sv3	e
straks	swV	Bm
strand	sx7	a
strejfe om	syV	w
strejke	szF	f
strube	szk	b
strygejern	sz/	v
stråle	s1R	i
stræde	s0u	j
strø	s1z	1
strøm	s2o	r
strømpe	s3T	j
student	s32	q
studere	s4g	d
studium	s49	e
stue	s5b	p
stueetage	s6E	t
stuepige	s6x	g
stum	s7R	m
stump	s73	q
stykke	s8h	m
styre	s+4	v
styre	s9H	Bx
stå	tBP	U
stå op	tCf	1
stål	tBj	i
stål	tCF	a
stænkskærm	s/n	q
stær	tAR	c
stærk	tAt	i
stød	tDU	Y
støde	tDs	l
stønne	tER	g
størrelse	tEx	BA
støtte	tFx	x
støv	tGi	X
støve af	tHW	g
støvet	tG5	d
støvle	tH2	h
støvsuger	tIX	BB
succes	tJY	q
suge	tKC	T
sukke	tKV	W
sukker	tKr	a
sult	tLF	X
sulten	tLc	c
sum	tL4	Z
sund	tMR	c
sundhed	tMt	e
suppe	tNL	W
supplement	tNh	m
sur	tOH	4
surrogat	tO/	n
svag	tPm	i
svalbard	tQI	j
svale	tQr	a
svamp	tRF	x
svane	tR2	X
svar	tSN	d
svare	tSq	p
svede	tTT	b
svejts	tTu	h
svejtser	tUP	h
svensk	tUw	c
svensker	tVM	g
sverige	tVs	g
svigerdatter	tWM	1
svigerfar	tXB	s
svigerforældre	tXt	BB
svigerinde	tYu	w
svigermor	tZe	x
svigersøn	taP	t
svin	ta8	h
svinekød	tbd	m
sving	tcD	f
svinge	tci	BJ
svoger	tdr	p
svulme	teU	c
sværge	tew	h
svært	tfR	m
svømme	tf3	j
sy	tga	Q
syd	tgq	V
sydamerika	tg/	z
sydlig	thy	m
sydpolen	tiY	z
syfilis	tjL	j
syg	tju	X
sygeplejerske	tkF	u
symbol	tkz	h
symfoni	tlU	n
sympatisk	tl7	p
symptom	tmk	f
syn	tnD	0
synagoge	tn3	m
synde	tod	j
synes	tpA	Bo
synes om	tqo	4
synge	trg	Z
synke	tr5	k
synlig	tsd	d
syre	ts6	V
syren	ttP	c
system	ttr	d
systematisk	tuI	w
sytten	tu4	f
syttende	tvX	l
syv	tv8	S
syvende	twO	e
så	t8t	2
så at sige	t/f	p
så snart som	uAI	w
sådan	t9j	j
således	t+G	p
sår	t+v	b
såre	t/K	V
sæbe	tws	a
sædvane	txG	w
sædvanlig	tx2	Bf
sædvanligvis	tzV	6
sæl	t0P	e
sælge	t0t	u
sælger	t1b	j
sænke	t1+	Y
sær	t2W	o
særlig	t2+	BU
særskilt	t4S	BC
sæter	t5U	p
sætning	t59	h
sætte	t6e	w
sætte pris på	t7O	6
sætte sig	t8I	l
sø	uA4	Z
sød	uBR	BA
søge	uCR	f
sølv	uCw	Y
søm	uDI	Z
sømand	uDh	g
søn	uEB	Y
søndag	uEZ	g
sørge	uE5	i
søskende	uFb	6
søster	uGV	j
søsterdatter	uG4	x
søstersøn	uHp	v
søsyge	uIY	m
søvn	uI+	c
søvnig	uJa	r
tab	uKF	V
tabel	uKa	2
taburet	uLQ	i
tag	uLy	V
tage	uMH	z
tage afsked	uNj	Bd
tage afsked med	uPA	Bp
tage afsted	uQp	j
tage bort	uRM	x
tage brusebad	uR9	v
tage fejl	uSs	x
tage hensyn til	uTd	CL
tage op	uVo	5
tagetes	uM6	p
tak	uWh	0
tak for det	ubs	w
takke	uXV	Y
takke for	uXt	z
taknemlig for	uYg	x
taknemmelig	uZR	p
taknemmelighed	uZ6	1
taks	uav	b
takt	ubK	i
tal	ucc	b
tale	uc3	o
talent	udf	x
talje	ueQ	m
tallerken	ue2	m
talord	ufc	i
tampon	uf+	p
tand	ugn	X
tandbørste	ug+	z
tandhjul	uhx	p
tandkød	uia	c
tandlæge	ui2	g
tandpasta	ujW	n
tandpine	uj9	g
tandstikker	ukd	q
tang	ulH	W
tank	uld	V
tanke	uly	b
tante	umN	a
tapet	umn	u
tapetsere	unV	q
tapetserer	un/	9
tapper	uo8	2
tarm	upy	Y
taxa	uqK	b
taxachauffør	uql	BH
te	urs	S
teater	ur+	i
tegn	usg	5
tegne	utZ	k
tegning	ut9	o
teknik	uul	q
teknisk	uvP	i
tekst	uvx	d
telefon	uwO	j
telefonere	uwx	t
telegrafere	uxe	v
telegram	uyN	j
teleskop	uyw	j
tema	uzT	k
tempel	uz3	b
temperatur	u0S	x
tempo	u1D	Z
tendens	u1c	7
tendentiøs	u2X	BB
tennis	u3Y	b
teori	u3z	c
tepotte	u4P	w
terapi	u4/	j
termoflaske	u5i	BP
termometer	u6x	v
terning	u7g	f
terrasse	u7/	i
terræn	u8h	t
test	u9O	U
testamente	u9i	v
teste	u+R	X
testikel	u+o	h
ti	u/J	Q
tid	u/Z	b
tidlig	u/0	c
tidligt	vAQ	e
tidsel	vAu	b
tidskrift	vBJ	7
tie	vCE	W
tiende	vCa	b
tiger	vC1	V
tigger	vDK	d
til	vDn	BU
til højre	vbw	2
til leje	vcm	j
til salg	vdJ	g
til venstre	vdp	3
tilbage	vE7	a
tilberedelse	vFV	z
tilbringe	vGI	3
tildragelse	vG/	BK
tilfreds	vIJ	1
tilfælde	vI+	BP
tilfældig	vKN	BC
tilfældigvis	vRN	5
tilføje	vLP	d
tilgive	vLs	n
tilgængelig	vMT	s
tilhænger	vM/	BB
tilhøre	vOA	l
tillade	vOl	8
tilladelse	vPh	BA
tillavning	vQh	s
tillid	vSG	v
tilløb	vS1	b
tilmelding	veg	BV
tilpasning	vTQ	3
tilsammen	vUH	j
tilskud	vUq	h
tilstand	vVL	BH
tilstrækkelig	vWS	3
tilstrømning	vXJ	BC
tilstå	vYL	7
tilsøle	vZG	e
tiltagende	vZk	n
tiltrække	vaL	l
tiltrækningskraft	vaw	BA
time	vf1	n
tin	vgc	S
ting	vgu	s
tirsdag	vha	k
tit	vh+	r
titel	vip	q
tjene	vjT	v
tjener	vkC	2
tjeneste	vk4	i
tjære	vla	Z
to	vlz	Q
to gange	vyJ	k
tog	vmD	T
togoverskæring	vmW	BB
toilet	vnX	c
toiletpapir	vnz	1
told	voo	Y
tolerant	vpA	l
tolk	vpl	d
tolv	vqC	X
tolvte	vqZ	d
tom	vq2	b
tomat	vrR	d
tommelfinger	vru	v
tone	vsd	U
top	vsx	7
torden	vts	k
tordne	vuQ	g
torn	vuw	U
torsdag	vvE	i
torsk	vvm	j
torv	vwJ	6
tosse	vxD	Z
tosset	vxc	t
tradition	vyt	q
trafik	vzX	f
tragedie	vz2	m
transistor	v0c	q
transport	v1G	n
transportere	v1t	z
trappe	v2g	n
tre	v3H	U
tre gange	v8h	z
tredive	v3b	f
tredje	v36	c
trehjulet cykel	v4W	1
trekant	v5L	f
tres	v5q	W
tresindstyve	v6z	q
tresindstyvende	v6A	z
tretten	v7d	f
trettende	v78	l
tribune	v9U	0
trist	v+I	BL
tro	v/T	B2
tro på	wCM	i
trompet	wBJ	h
tropisk	wBq	i
true	wCu	h
trussel	wDP	m
tryk	wD1	n
trykke	wEc	6
trykke ud	wFW	s
tråd	wPe	o
træ	wGC	Z
træ	wGb	r
træde	wHG	6
træffe	wIA	6
træfning	wI6	BB
træk	wJ7	W
trækharmonika	wKR	3
trække	wLI	1
trække op	wL9	v
trækpapir	wMs	+
trænge til	wOX	w
trængende	wNq	t
træt	wPH	X
trøst	wQG	h
trøste	wQn	p
tudse	wRQ	X
tulipan	wRn	k
tunfisk	wSL	z
tung	wS+	q
tunge	wTo	k
turde	wUM	e
tusinde	wUq	u
tusmørke	wVY	p
tvetydig	wWB	l
tvilling	wWm	r
tvinge	wXR	k
tvivl	wX1	Z
tvivle	wYO	c
tværs	wYq	7
tværtimod	wZl	BA
tydelig	wal	u
tyfus	wbT	b
tygge	wbu	Y
tyk	wcG	q
tynd	wcw	BI
typisk	wd4	c
tyr	weU	W
tyrk	weq	Y
tyrkiet	wfC	m
tysk	wfo	z
tysker	wgb	d
tyskland	wg4	f
tyv	whX	Y
tyve	whv	W
tyvende	wiF	f
tyveri	wik	r
tå	woZ	Q
tåge	wop	b
tåle	wpE	x
tålmodig	wp1	k
tålmodighed	wqZ	w
tåre	wrJ	V
tårn	wre	h
tælle	wjP	Y
tænde	wjn	g
tænding	wkH	g
tændrør	wkn	x
tændstik	wlY	f
tænke	wl3	Z
tæppe	wmQ	n
tærte	wm3	g
tæt	wnX	BC
tøffel	wr/	e
tøj	wsd	i
tøjklemme	ws/	0
tømme	wtz	a
tør	wuN	X
tørhed	wuk	k
tørklæde	wvI	n
tørre	wvv	d
tørst	wwM	e
tørstig	wwq	m
tøve	wxQ	n
tøvejr	wx3	m
uafbrudt	wyd	+
uafhængig	wzb	t
uafhængighedsdag	w0I	BC
uafhængighedserklæring	w1K	Bm
uafhængighedskamp	w2w	BK
uafhængighedskrig	w36	BK
ubehagelig	w5E	BW
ud	w6a	Z
udbytte	w6z	s
uddannelsesinstitution	w7f	Bg
uddunstning	w8/	p
udelade	w9o	BC
udelukke	w+q	j
udelukkende	w/N	9
uden	xAK	a
uden tvivl	xAk	5
udenad	xBd	f
udenfor	xB8	t
udenlandsk	xCp	s
udenrigsminister	xDV	BU
udenrigsministerium	xEp	Bg
udenrigspolitik	xGJ	BD
udfald	xHM	v
udfordre	xH7	BH
udfordring	xJC	y
udgang	xJ0	p
udgift	xKd	l
udgive	xLC	r
udkast	xLt	f
udkomme	xMw	BK
udkommentere	xN6	5
udland	xMM	k
udle	xOz	a
udleje	xPN	n
udlænding	xP0	q
udmeldelse	xQe	t
udnytte	xRL	o
udnævnelse	xRz	q
udrydde	xSd	t
udsende	xTK	k
udsigt	xTu	z
udskifte	xUh	w
udslukke	xVR	v
udstille	xWA	l
udstilling	xWl	5
udsætte	xXe	0
udtale	xYS	i
udtryk	xY0	v
udtrykke sig	xZj	6
udtrædelse	xad	x
udvidelse	xbO	r
udvikle	xb5	x
udvikling	xcq	9
udviklingsbiologi	xdn	BY
udånde	xgj	m
udødeliggøre	xe/	8
udørken	xf7	o
uenig	xhJ	p
uenighed	xhy	+
ufordelagtig	xiw	BB
uge	xjx	V
ugedag	xkG	l
ugentlig	xkr	e
ugift	xlJ	t
ugle	xl2	W
uglebestand	xmM	y
ugleklo	xm+	j
uhøflig	xnh	k
uld	xoF	W
ulempe	xob	l
ulv	xpA	Y
ulykke	xpY	i
ulykkelig	xp6	q
ulykkeligvis	xqk	7
ulykkesbil	xrf	BY
ulykkestilfælde	xs3	6
umuliggøre	xtx	2
under	xun	9
under	xvk	e
underarm	xwC	v
underbukser	xwx	BE
undergrundsbane	xx1	BD
underholdning	xy4	6
underkjole	xzy	w
underkop	x0i	o
underlig	x1K	4
underofficer	x2C	BQ
underskrift	x3S	y
underskrive	x4E	t
understrege	x4x	8
undersøge	x5t	BW
undersøgelse	x7D	Bn
undertegne	x8q	q
undertiden	x9U	BE
undertrøje	x/T	t
undertøj	x+Y	7
underverden	yAA	1
undervise	yA1	o
undervisning	yBd	1
undfly	yCS	l
undgå	yC3	k
undkomme	yDb	q
undre sig	yEF	9
undskyld	yFC	t
undskyld mig	yHu	q
undskylde	yFv	l
undskylde sig	yGU	v
undskyldning	yHD	r
undtagelse	yIY	m
undvige	yI+	k
undvigelseshastighed	yJi	BO
ung	yKw	q
ungarer	yMs	l
ungarn	yNR	g
ungdom	yNx	g
ungdomsorganisation	yLa	BS
ungkarl	yOR	h
uniform	yOy	k
universitet	yPW	0
uoverskuelig	yQK	z
upartisk	yQ9	s
upålidelig	yRp	s
ur	ySV	l
uregelmæssig	yS6	u
urin	yTo	d
urinblære	yUF	3
urinere	yU8	p
urinrør	yVl	t
urmager	yWS	q
urtepotte	yW8	y
usa	yXu	z
usand	yYh	f
uskadeliggøre	yZA	5
uskyld	yZ5	j
uskyldig	yac	y
usympatisk	ybO	r
utaknemlig	yb5	BE
utilfreds	yc9	BG
utopisk	yeD	p
utydelig	yes	q
utålmodig	yfW	u
utøj	ygE	f
uundværlig	ygj	3
uvenlig	yha	Bm
uærlig	yjA	k
valg	yjk	j
valnød	ykH	j
valse	ykq	Y
valuta	ylC	e
vand	ylg	Y
vandfald	yl4	j
vandmelon	ymb	w
vane	ynL	n
vanille	yny	j
vanlig	yoV	BZ
vanskelig	ypu	5
vare	yqn	w
varieté	yrX	1
varm	ysM	U
varme	ysg	Z
vase	ys5	d
vaseline	ytW	i
vaske	yt4	X
vaske op	yvq	k
vaskeskind	yuz	3
vasketøj	yuP	k
vat	ywO	k
ved	ywy	h
vedbend	yxT	c
vedrørende	yxv	BI
vegetar	yy3	p
vegetarisk	yzg	u
vej	y0O	k
veje	y0y	Y
vejr	y1K	e
vejviser	y1o	u
veksle	y2W	n
velhavende	y29	BE
ven	y4B	Z
vende	y4a	u
vending	y5I	g
veninde	y5o	k
venlig	y6M	9
venskab	y7J	l
venskabelig	y7u	p
venstre	y8X	m
ventesal	y89	6
ventil	y93	k
ventilator	y+b	7
verden	y/W	e
verdensdel	y/0	6
verdenskrig	zAu	x
vermouth	zCU	m
vest	zC6	x
vestlig	zDr	f
vi	zEK	S
vi ses	zap	q
vid	zEc	3
vide	zFT	f
videnskab	zFy	n
videnskabelig	zGZ	w
videnskabsmand	zHJ	0
videre	zH9	Bk
vigtig	zJh	s
vild	zKN	d
vilje	zKq	w
villa	zLa	x
ville	zML	t
vin	zM4	Y
vind	zNQ	Z
vinde	zNp	n
vindrue	zOQ	i
vindue	zOy	f
vindueskarm	zPR	v
vinduesrude	zQA	2
vinflaske	zQ2	s
vinge	zRi	d
vinke	zR/	Z
vinkel	zSY	g
vinstok	zS4	u
vinter	zTm	i
viol	zUI	e
violin	zUm	m
virke på	zWS	+
virkelig	zVM	BG
vise	zXQ	u
visit	zX+	b
viskelæder	zYZ	t
viskestykke	zZG	BD
visum	zaJ	g
vogn	zbT	8
vokal	zcP	Z
vokse	zco	i
voksen	zdK	8
vor	zeG	R
vort	zeX	V
vorte	zes	Z
vove	zfF	e
vred	zfj	f
vulgær	zgC	0
vulkan	zg2	d
vurdere	zhT	3
våben	z7g	b
våd	z77	U
vågen	z8P	a
vågne op	z8p	s
vædde	ziK	f
væg	zip	V
væge	zi+	d
vægre sig	zjb	y
vægt	zkN	m
vække	zkz	w
vækkeur	zlj	u
vækst	zmR	q
vælge	zm7	r
vælling	znm	q
væmmelse	zoQ	q
vær så god at	z5d	0
værdi	zo6	j
værdifuld	zpd	BQ
være	zqt	W
være bange	zrp	3
være bange for	zsg	BB
være borte	zth	4
være enig med	zuZ	3
være født	zvQ	x
være heldig	zwB	8
være i slægt med	zw9	BA
være ked af	zx9	+
være ked af det	zy7	BP
være misundelig	z0K	w
være misundelig på	z06	4
være uheldig	z1y	z
være vild efter	z2l	BD
være værd	z3o	7
værelse	zrD	m
værktøj	zBf	1
værre	z4j	e
værst	z5B	c
væsel	z6R	b
væske	z6s	b
væve	z7H	Z
watt	z9V	T
wcrulle	z9o	t
weekend	z+V	i
whiskysovs	z+3	v
wikikode	z/m	BC
yacht	0Ao	a
yak	0BC	BH
yakokse	0CJ	BV
yams	0De	1
yankee	0ET	3
ydedygtig	0FK	v
ydre	0F5	u
ynde	0Gn	X
yndlingsfarve	0G+	9
ynglebestand	0H7	8
yoga	0I3	t
yoghurt	0Jk	+
ypperstepræst	0Ki	6
ypsilon	0Lc	7
ytringsfrihed	0MX	BB
ytterbium	0NY	BB
yver	0OZ	d
zink	0O2	Z
zone	0PP	Y
zoologisk have	0Pn	x
å	1Dd	R
åben	1Du	W
åbenbare	1EE	s
åbne	1Ew	f
åbning	1FP	e
åbningstid	1Ft	w
ådre	1Gd	b
ådsel	1G4	BN
ådselgrib	1IF	u
ådselæder	1Iz	y
ål	1Jl	BP
ålegræs	1K0	m
ånd	1La	v
ånde	1MJ	n
åndedræt	1Mw	u
åndedrætsværn	1Ne	/
år	1Od	U
åre	1Ox	h
århundrede	1PS	6
årlig	1QM	j
årring	1Qv	k
årsag	1RT	l
årstid	1R4	j
årsværk	1Sb	2
årti	1TR	e
årtusind	1Tv	q
årtusinde	1UZ	t
ås	1VG	W
åsted	1Vc	r
åsyn	1WH	i
æble	0QY	b
æblejuice	0Qz	w
æblekerne	0Rj	t
æblesaft	0SQ	r
æbleskive	0S7	Bm
æbletræ	0Uh	p
æbletærte	0VK	v
æblevin	0V5	k
æde	0Wd	Y
ædel	0W1	z
ædelgas	0Xo	n
ædelgran	0YP	m
ædelmetal	0Y1	w
ædelsten	0Zl	m
ædru	0aL	f
æg	0aq	b
ægge	0bF	c
æggebakke	0bh	r
æggebæger	0cM	t
æggeleder	0c5	1
æggeskal	0du	o
æggestok	0eW	o
ægir	0e+	g
ægte	0fe	2
ægte	0gU	c
ægtefælle	0gw	/
ægtemand	0hv	l
ægtepar	0iU	z
ægteskab	0jH	y
ægyptisk	0j5	t
ækel	0km	p
ækvator	0lP	j
ælling	0ly	i
ændre	0n5	z
ændring	0os	Bf
ændringsforslag	0mU	BE
æneas	0nY	h
æolisk	0qL	l
ære	0qw	i
ærefrygt	0rS	n
ærgerrighed	0r5	z
ærgre sig	0ss	y
ærgre sig over	0te	BW
ærkebiskop	0u0	2
ærlig	0vq	w
ærme	0wa	f
ærmeløs	0w5	y
ært	0xr	Z
ærværdig	0yE	x
æsel	0y1	h
æter	0zW	c
ø	038	V
ødelægge	04R	s
ødelæggelse	049	w
øje	05t	T
øjeblik	06A	p
øjenbryn	06p	s
øjenlåg	08J	i
øjenlæge	07V	0
økse	08r	b
øl	09G	c
ønske	09i	t
øre	0+P	Y
ørering	0+n	p
ørn	0/Q	d
øse	0/t	j
øst	1AQ	b
østers	1Ar	f
østersøen	0zy	0
østlig	1BK	p
østrig	02v	k
østriger	03T	p
østrus	00m	l
østtimor	01L	x
østtyskland	018	z
øve	1Bz	j
øvelse	1CW	q
øverst	1DA	d
